実施 する 	 じっし する
にっこりし 	 にっこりし
買っ て 	 かっ て
て 	 て
宣伝 	 せんでん
率いる 	 ひきいる
跋扈 し た 	 ばっこ し た
し て 	 し て
持っ た 	 もっ た
あぶれ た 	 あぶれ た
生かし て 	 いかし て
披露 し 	 ひろう し
巡業 し た 	 じゅんぎょう し た
発展 し て 	 はってん し て
建設 さ れ て 	 けんせつ さ れ て
復旧 し た 	 ふっきゅう し た
なじま せ 	 なじま せ
焦げ付か せ ない ように する 	 こげつか せ ない ように する
介し て 	 かいし て
使用 でき た 	 しよう でき た
なっ た 	 なっ た
作成 する 	 さくせい する
受傷 	 じゅしょう
集中 する 	 しゅうちゅう する
貢献 し た 	 こうけん し た
あっ て 	 あっ て
潰さ れる 	 つぶさ れる
突出 	 とっしゅつ
備わっ て 	 そなわっ て
活かし 	 いかし
解決 し た 	 かいけつ し た
開発 さ れ 	 かいはつ さ れ
命名 さ れ た 	 めいめい さ れ た
あり 	 あり
登場 	 とうじょう
上がっ た 	 あがっ た
入っ た 	 はいっ た
伝え られ て 	 つたえ られ て
監禁 さ れ た 	 かんきん さ れ た
搭載 し 	 とうさい し
取り込ん だ 	 とりこん だ
検知 し て 	 けんち し て
調整 する 	 ちょうせい する
節電 する 	 せつでん する
結ぶ 	 むすぶ
通る 	 とおる
し た 	 し た
思っ て 	 おもっ て
含め て 	 ふくめ て
食べ られる 	 たべ られる
移籍 する 	 いせき する
広がっ た 	 ひろがっ た
つくり出し て 	 つくりだし て
受け て 	 うけ て
示し て 	 しめし て
ある 	 ある
通じ て 	 つうじ て
殺害 	 さつがい
殺害 する 	 さつがい する
納得 し た 	 なっとく し た
行わ れる 	 おこなわ れる
安心 し て 	 あんしん し て
受け られ まし た 	 うけ られ まし た
感動 し まし た 	 かんどう し まし た
繋がる 	 つながる
配布 し て 	 はいふ し て
実施 	 じっし
在り 	 ざいり
含め 	 ふくめ
めぐる 	 めぐる
展開 さ れ そうだ 	 てんかい さ れ そうだ
できる 	 できる
前倒し し て 	 まえだおし し て
実施 し て 	 じっし し て
持ち込ん だ 	 もちこん だ
確認 せ ず 	 かくにん せ ず
進入 し た 	 しんにゅう し た
対応 し ます 	 たいおう し ます
入れる 	 いれる
思い ます 	 おもい ます
ばらまい て 	 ばらまい て
言い放っ た 	 いいはなっ た
死亡 し た 	 しぼう し た
目指し たい 	 めざし たい
拒否 	 きょひ
下っ て 	 くだっ て
たどり 	 たどり
着い た 	 つい た
断念 し 	 だんねん し
高め た 	 たかめ た
登場 し て 	 とうじょう し て
入手 し 易く なっ た 	 にゅうしゅ し やすく なっ た
改心 し た 	 かいしん し た
庇っ て 	 かばっ て
負傷 し 	 ふしょう し
撃た れる 	 うた れる
投降 	 とうこう
出会っ た 	 であっ た
憧れ て 	 あこがれ て
なり 	 なり
続い て 	 つづい て
該当 する 	 がいとう する
叫び 	 さけび
復唱 し 	 ふくしょう し
めくり 	 めくり
見せる 	 みせる
続き 	 つづき
生産 さ れ て 	 せいさん さ れ て
成功 さ せ た 	 せいこう さ せ た
喫し 	 きっし
インターセプト し た 	 いんたーせぷと し た
決め られ 	 きめ られ
敗れ た 	 やぶれ た
含まれる 	 ふくまれる
分け られる 	 わけ られる
連携 し て 	 れんけい し て
使っ た 	 つかっ た
支援 し 	 しえん し
目指す 	 めざす
削除 さ れる 	 さくじょ さ れる
呼び 	 よび
進ん 	 すすん
見 て 	 み て
あ れ 	 あ れ
違う 	 ちがう
生き て 	 いき て
なし 	 なし
連絡 し て 	 れんらく し て
率い た 	 ひきい た
終わっ た 	 おわっ た
い て 	 い て
教え て 	 おしえ て
決まる 	 きまる
聞い て 	 きい て
感激 し まし た 	 かんげき し まし た
招い た 	 まねい た
聞か れ た 	 きか れ た
答え て 	 こたえ て
見える 	 みえる
行なっ て 	 おこなっ て
呟く ように 	 つぶやく ように
使う 	 つかう
見 たい 	 み たい
語り 	 かたり
使用 する 	 しよう する
示す 	 しめす
健在 	 けんざい
つくる 	 つくる
のっ て 	 のっ て
開催 さ れ た 	 かいさい さ れ た
喧伝 し て 	 けんでん し て
失業 し て 	 しつぎょう し て
困窮 し て 	 こんきゅう し て
軽減 し 	 けいげん し
免除 する 	 めんじょ する
安心 する 	 あんしん する
持たせ た 	 もたせ た
参戦 する 	 さんせん する
任官 する 	 にんかん する
使っ て 	 つかっ て
家出 し た 	 いえで し た
捜し て 	 さがし て
わから ない 	 わから ない
授業 	 じゅぎょう
導入 し て 	 どうにゅう し て
収録 さ れ て 	 しゅうろく さ れ て
もたらす 	 もたらす
考える 	 かんがえる
行っ て 	 いっ て
参加 し て 	 さんか し て
生活 し て 	 せいかつ し て
リラックス 出来 ます 	 りらっくす でき ます
食べ すぎ ちゃい ます 	 たべ すぎ ちゃい ます
相次ぐ ように なる 	 あいつぐ ように なる
収納 し 	 しゅうのう し
持っ て 	 もっ て
のぞく 	 のぞく
失脚 さ せ た 	 しっきゃく さ せ た
反発 し た 	 はんぱつ し た
残り 	 のこり
保管 さ れ て 	 ほかん さ れ て
指数化 し て 	 しすうか し て
スタート し た 	 すたーと し た
通り 	 とおり
向かう 	 むかう
置く 	 おく
搭載 し た 	 とうさい し た
発表 	 はっぴょう
かかわら ず 	 かかわら ず
落ち着 ける 	 おちつ ける
載っ て 	 のっ て
拘束 さ れ 	 こうそく さ れ
解放 さ れる 	 かいほう さ れる
挙がっ て 	 あがっ て
関連 する 	 かんれん する
優勝 し 	 ゆうしょう し
与え た 	 あたえ た
選ば れる 	 えらば れる
なり まし た 	 なり まし た
認め ませ ん 	 みとめ ませ ん
出演 し た 	 しゅつえん し た
入れ替え する 	 いれかえ する
とっ た 	 とっ た
開か れる 	 ひらか れる
なっ て 	 なっ て
開催 せ ず 	 かいさい せ ず
なる 	 なる
あり ます 	 あり ます
登場 する 	 とうじょう する
許さ れる 	 ゆるさ れる
師事 し 	 しじ し
出 て 	 で て
相当 する 	 そうとう する
就か ず 	 つか ず
据え た 	 すえ た
行け ず 	 いけ ず
接続 	 せつぞく
出世 する 	 しゅっせ する
さ れ 	 さ れ
出る 	 でる
合わせ 	 あわせ
入れ替え 	 いれかえ
働き 始める 	 はたらき はじめる
乗り入れ 	 のりいれ
直通運転 する 	 ちょくつううんてん する
整っ て 	 ととのっ て
受け やすい 	 うけ やすい
見 られる 	 み られる
基づい た 	 もとづい た
思わ れ ます 	 おもわ れ ます
省き ます 	 しょうき ます
合格 し た 	 ごうかく し た
参加 でき ます 	 さんか でき ます
報じ て 	 ほうじ て
否定 し まし た 	 ひてい し まし た
戻し 	 もどし
位置 する 	 いち する
完成 し 	 かんせい し
行わ れ た 	 おこなわ れ た
備える 	 そなえる
老い て 	 おい て
優れ て 	 すぐれ て
対応 し て 	 たいおう し て
狙う 	 ねらう
さ れる 	 さ れる
略す 	 りゃくす
請求 する 	 せいきゅう する
委ねる 	 ゆだねる
気に入っ て 	 きにいっ て
通っ て 	 かよっ て
はまっ ちゃっ た 	 はまっ ちゃっ た
気づ かさ れ た 	 きづ かさ れ た
リード し た 	 りーど し た
加点 	 かてん
使わ れ て 	 つかわ れ て
位置 し て 	 いち し て
訪れ た 	 おとずれ た
合わせ て 	 あわせ て
選ぶ 	 えらぶ
でき ます 	 でき ます
担当 する 	 たんとう する
赴き 	 おもむき
表明 し た 	 ひょうめい し た
貫通 する 	 かんつう する
誇る 	 ほこる
入社 	 にゅうしゃ
抱える 	 かかえる
拡がる 	 ひろがる
惧れ た 	 おそれ た
集め 	 あつめ
開い た 	 ひらい た
適用 さ れ ない 	 てきよう さ れ ない
なる みたい です 	 なる みたい です
使用 し 	 しよう し
行う 	 おこなう
隆盛 し た 	 りゅうせい し た
祀ら れ た 	 まつら れ た
取り消さ れ て 	 とりけさ れ て
いる 	 いる
聞い た 	 きい た
表示 	 ひょうじ
にぎり 	 にぎり
開催 し 	 かいさい し
協議 し て 	 きょうぎ し て
運行 する 	 うんこう する
降り 	 おり
通じる 	 つうじる
向け て 	 むけ て
歩く 	 あるく
入れ て 	 いれ て
競技 する 	 きょうぎ する
合っ た 	 あっ た
履い て 	 はい て
する 	 する
やり たい 	 やり たい
浮かす 	 うかす
暮らす 	 くらす
利用 し た 	 りよう し た
着せ 	 きせ
終了 し た 	 しゅうりょう し た
経 て 	 へ て
務め た 	 つとめ た
いただい た 	 いただい た
考え抜か れ た 	 かんがえぬか れ た
いただけ ます 	 いただけ ます
派生 する 	 はせい する
披露 さ れ た 	 ひろう さ れ た
セッション さ れ た 	 せっしょん さ れ た
構成 さ れ た 	 こうせい さ れ た
博し た 	 ひろしし た
獲得 	 かくとく
合流 し 	 ごうりゅう し
公布 さ れ た 	 こうふ さ れ た
呼ば れ て 	 よば れ て
厭わ ず 	 いやわ ず
行動 し 	 こうどう し
消え て 	 きえ て
馳せる 	 はせる
差し た 	 さし た
ござい ます 	 ござい ます
握る 	 にぎる
見 出す 	 み いだす
狙っ た 	 ねらっ た
リラックス でき 	 りらっくす でき
癒さ れ まし た 	 いやさ れ まし た
疲れ て 	 つかれ て
笑わせ た 	 わらわせ た
揃っ て 	 そろっ て
相続 し た 	 そうぞく し た
受け継ぎ 	 うけつぎ
当選 する 	 とうせん する
予約 し て 	 よやく し て
来 たいです 	 き たいです
優勝 し た 	 ゆうしょう し た
観 た 	 み た
仰ぐ べく 	 あおぐ べく
進学 	 しんがく
倒れ て 	 たおれ て
行き 	 いき
連打 する 	 れんだ する
踏みつける 	 ふみつける
食べ 	 たべ
行き まし た 	 いき まし た
混雑 し て 	 こんざつ し て
垣間見 える 	 かきまみ える
買う 	 かう
殺す よう 	 ころす よう
進言 し た 	 しんげん し た
叛く 	 そむく
つく 	 つく
せ ず 	 せ ず
招い て 	 まねい て
もっ て 	 もっ て
害し 	 がいし
し ない 	 し ない
去り たい 	 さり たい
せよ 	 せよ
渡し た 	 わたし た
発行 さ れ て 	 はっこう さ れ て
知ら なかっ た 	 しら なかっ た
実装 する 	 じっそう する
用い て 	 もちい て
繋げる 	 つなげる
あふれる 	 あふれる
出航 する 	 しゅっこう する
切断 さ れ た 	 せつだん さ れ た
かぶせる ように し て 	 かぶせる ように し て
重ね て 	 かさね て
貼っ て 	 はっ て
取り入れ て 	 とりいれ て
勧め です 	 すすめ です
言う 	 いう
する ような 	 する ような
行け 	 いけ
兼任 する 	 けんにん する
書い て 	 かい て
止め よう 	 とめ よう
思っ たら 	 おもっ たら
ぶっかけ 	 ぶっかけ
混ぜ て 	 まぜ て
食べ て 	 たべ て
真似 し たく て 	 まね し たく て
頼ん だ 	 たのん だ
来場 	 らいじょう
並ん 	 なみん
覚え て 	 おぼえ て
明かし 	 あかし
否定 し た 	 ひてい し た
伝達 する 	 でんたつ する
担い 	 にない
協力 し て 	 きょうりょく し て
支援 する 	 しえん する
相次い 	 あいつい
注目 	 ちゅうもく
取り組む 	 とりくむ
計上 し た 	 けいじょう し た
呼ば れる 	 よば れる
飼育 さ れる 	 しいく さ れる
い た 	 い た
雇わ れ た 	 やとわ れ た
伴い 	 ともない
雇わ れる 	 やとわ れる
残存 する 	 ざんぞん する
図っ た 	 ずっ た
賄っ て 	 まかなっ て
明言 さ れ て 	 めいげん さ れ て
離婚 し た 	 りこん し た
引き取ら れ 	 ひきとら れ
居候 し 	 いそうろう し
励ん だ 	 はげん だ
起こし た 	 おこし た
影響 さ れ た 	 えいきょう さ れ た
思わ れる 	 おもわ れる
貼っ 	 はっ
あおぐ 	 あおぐ
寄せ付け ない ような 	 よせつけ ない ような
在籍 し 	 ざいせき し
受け 	 うけ
読む 	 よむ
あっ た 	 あっ た
知っ て 	 しっ て
共有 できる 	 きょうゆう できる
立ち上げ ます 	 たちあげ ます
使用 さ れる 	 しよう さ れる
組み合わせ て 	 くみあわせ て
使わ れる 	 つかわ れる
配信 する 	 はいしん する
更新 さ れ 	 こうしん さ れ
更新 	 こうしん
しまっ て 	 しまっ て
入っている 	 はいっている
開け て 	 あけ て
見る 	 みる
検挙 さ れ た 	 けんきょ さ れ た
否定 し 続け た 	 ひてい し つづけ た
越し 	 ごし
罹患 し た 	 りかん し た
所在 し 	 しょざい し
祀る 	 まつる
予定 さ れ て 	 よてい さ れ て
関わり 	 かかわり
問題 	 もんだい
視 さ れ 	 し さ れ
あり まし た 	 あり まし た
探訪 し た 	 たんぼう し た
懸念 し て 	 けねん し て
暮らし て 	 くらし て
掲載 さ れ 	 けいさい さ れ
押し付け られ て 	 おしつけ られ て
よる 	 よる
訪れ 	 おとずれ
注目 さ れ て 	 ちゅうもく さ れ て
与える 	 あたえる
考え られ て 	 かんがえ られ て
含まれ て 	 ふくまれ て
作動 する 	 さどう する
比較 し て 	 ひかく し て
かかる 	 かかる
要求 さ れる 	 ようきゅう さ れる
買っ た 	 かっ た
所有 する 	 しょゆう する
配置 さ れ て 	 はいち さ れ て
配置 さ れる 	 はいち さ れる
窺 える 	 うかが える
想定 	 そうてい
利く よう 	 きく よう
開発 し た 	 かいはつ し た
探り 	 さぐり
釣る 	 つる
含め た 	 ふくめ た
上がる 	 あがる
用い られる 	 もちい られる
作成 し て 	 さくせい し て
届け ず 	 とどけ ず
持ち歩い て 	 もちあるい て
満た ず 	 みた ず
高める 	 たかめる
浮かび上がっ た 	 うかびあがっ た
愛する 	 あいする
向け た 	 むけ た
いき まし た 	 いき まし た
泊まり たく ない 	 とまり たく ない
持つ 	 もつ
窺い 始め て 	 うかがい はじめ て
発言 し 	 はつげん し
批判 し た 	 ひはん し た
行動 する 	 こうどう する
捕獲 さ れ た 	 ほかく さ れ た
居る 	 いる
告げ た 	 つげ た
できれ 	 できれ
願いし て 	 ねがいし て
終え た 	 おえ た
辞職 する 	 じしょく する
おっしゃっ た ように 	 おっしゃっ た ように
つい て 	 つい て
見え ない 	 みえ ない
触ら ない 	 さわら ない
き け なかっ た 	 き け なかっ た
ある ように 	 ある ように
達し た 	 たっし た
激励 し 	 げきれい し
自立 し た 	 じりつ し た
より 良い 	 より よい
貢献 し て 	 こうけん し て
啓蒙 する 	 けいもう する
選任 さ れる 	 せんにん さ れる
予納 する 	 よのう する
利用 さ れ て 	 りよう さ れ て
刊行 さ れ て 	 かんこう さ れ て
発表 さ れ て 	 はっぴょう さ れ て
倒産 し た 	 とうさん し た
回復 し た 	 かいふく し た
減っ た 	 へっ た
転じ まし た 	 てんじ まし た
落ち着か ない 	 おちつか ない
無くなら ない 	 なくなら ない
退化 さ せ た 	 たいか さ せ た
昇格 	 しょうかく
持つ ように なっ た 	 もつ ように なっ た
学び 	 まなび
往復 し 	 おうふく し
取材 し て 	 しゅざい し て
一巡 し 	 いちじゅん し
振 らす 	 ふ らす
占める ように なっ て 	 しめる ように なっ て
除き 	 のぞき
偽っ た 	 いつわっ た
入信 し て 	 にゅうしん し て
かけ て 	 かけ て
貸し て 	 かし て
取ら ない ように し 	 とら ない ように し
取りやめ させ 	 とりやめ させ
減らす 	 へらす
取っ た 	 とっ た
放送 さ れ た 	 ほうそう さ れ た
活躍 し た 	 かつやく し た
抹殺 する 	 まっさつ する
組織 し た 	 そしき し た
勝ち 	 かち
繋がっ た 	 つながっ た
記載 し ない 	 きさい し ない
思っ た らしく 	 おもっ た らしく
返そ う 	 かえ そう
改造 さ れ 	 かいぞう さ れ
廃車 さ れ た 	 はいしゃ さ れ た
禁止 する 	 きんし する
楽しん 	 たのしん
釣っ て 	 つっ て
支え て 	 ささえ て
潰し た 	 つぶし た
リタイヤ し 	 りたいや し
入賞 する 	 にゅうしょう する
こなす 	 こなす
得 られ ない 	 え られ ない
属し ます 	 ぞくし ます
忘れ て 	 わすれ て
リラックス でき ます 	 りらっくす でき ます
迎え た 	 むかえ た
守っ て 	 まもっ て
普及 さ せ て 	 ふきゅう さ せ て
輸出 し て 	 ゆしゅつ し て
就い て 	 つい て
上げ て 	 あげ て
統治 し て 	 とうち し て
めぐっ て 	 めぐっ て
争っ て 	 あらそっ て
保護 する 	 ほご する
支援 し た 	 しえん し た
考え ましょ う 	 かんがえ ましょ う
言っ て 	 いっ て
なれ 	 なれ
貰 え ます 	 もら え ます
問い合わせ 	 といあわせ
ください 	 ください
作り まし た 	 つくり まし た
読み 	 よみ
図る 	 はかる
し 	 し
要請 する 	 ようせい する
決め た 	 きめ た
起き た 	 おき た
関与 し て 	 かんよ し て
達成 さ せる 	 たっせい さ せる
対峙 する 	 たいじ する
くっ て 	 くっ て
増加 する 	 ぞうか する
対応 し 	 たいおう し
行なわ れ た 	 おこなわ れ た
使用 さ れ て 	 しよう さ れ て
使用 し た 	 しよう し た
運行 さ れ た 	 うんこう さ れ た
逮捕 さ れ た 	 たいほ さ れ た
渡っ て 	 わたっ て
働い て 	 はたらい て
並ぶ 	 ならぶ
言わ れる 	 いわ れる
進ん だ 	 すすん だ
渡さ れ ない 	 わたさ れ ない
凝らし た 	 こらし た
浮かぶ ようだ 	 うかぶ ようだ
包含 し た 	 ほうがん し た
加速 さ せ た 	 かそく さ せ た
跳ね上がっ た 	 はねあがっ た
追従 でき ず 	 ついじゅう でき ず
失っ た 	 うしなっ た
話し 	 はなし
盛り上がっ て 	 もりあがっ て
見れ 	 みれ
判断 でき た ような 	 はんだん でき た ような
間違え て 	 まちがえ て
石化 し た 	 せきか し た
所持 し て 	 しょじ し て
安置 さ れ て 	 あんち さ れ て
求める 	 もとめる
楽し め ます 	 たのし め ます
比べ て 	 くらべ て
持続 する 	 じぞく する
優れ た 	 すぐれ た
持ち 	 もち
使える 	 つかえる
重宝 さ れ 	 ちょうほう さ れ
投入 さ れ 	 とうにゅう さ れ
使用 さ れ た 	 しよう さ れ た
携帯 し て 	 けいたい し て
み 出し た 	 み でし た
座る 	 すわる
とどまる 	 とどまる
すべ て 	 すべ て
設置 さ れ 	 せっち さ れ
至る 	 いたる
伝える 	 つたえる
来る 	 くる
伝え ない 	 つたえ ない
引か ない 	 ひか ない
向い て 	 むい て
減点 さ れる 	 げんてん さ れる
呼ぶ 	 よぶ
呼ん だ 	 よん だ
つ ける 	 つ ける
使え ず 	 つかえ ず
し なければ なら ない 	 し なければ なら ない
生じる 	 しょうじる
伸び て 	 のび て
作る 	 つくる
召集 し た 	 しょうしゅう し た
いわ れる 	 いわ れる
召集 	 しょうしゅう
リリース し て 	 りりーす し て
復帰 する 	 ふっき する
あり ませ ん 	 あり ませ ん
鍛え られ た 	 きたえ られ た
応える 	 こたえる
はね た 	 はね た
負ける 	 まける
蹴り 	 けり
かかっ て 	 かかっ て
亡くなっ て 	 なくなっ て
食べ まし た 	 たべ まし た
いう 	 いう
止め た 	 とめ た
思っ た 	 おもっ た
職務質問 	 しょくむしつもん
掛ける 	 かける
選 べる 	 えら べる
発売 する 	 はつばい する
きる 	 きる
取り付け た 	 とりつけ た
刈り取っ た 	 かりとっ た
取り除い て 	 とりのぞい て
仕上げる 	 しあげる
分から なかっ た 	 わから なかっ た
歪ま せる 	 ひずみま せる
感じ た 	 かんじ た
散見 する 	 さんけん する
崩す 	 くずす
近づい て 	 ちかづい て
放っ 	 はなっ
発生 さ せ て 	 はっせい さ せ て
攻撃 する 	 こうげき する
配列 し て 	 はいれつ し て
描く 	 えがく
主宰 する 	 しゅさい する
入り 	 いり
仰い 	 あおい
迎える 	 むかえる
でき まし た 	 でき まし た
行く 	 いく
歩い て 	 あるい て
迷わ ず 	 まよわ ず
行っ ちゃい ます 	 いっ ちゃい ます
はじめ 	 はじめ
提出 し た 	 ていしゅつ し た
変わっ て 	 かわっ て
広々とし て 	 ひろびろとし て
説明 し て 	 せつめい し て
遭遇 する 	 そうぐう する
イラっと し ます 	 いらっと し ます
訪問 する 	 ほうもん する
装備 さ れる ように なっ て 	 そうび さ れる ように なっ て
わかり やすい です 	 わかり やすい です
称し 	 しょうし
廃し た 	 すたし た
導入 し た 	 どうにゅう し た
用いる 	 もちいる
検討 さ れ て 	 けんとう さ れ て
分析 さ れ た 	 ぶんせき さ れ た
似 た ような 	 に た ような
あらわれ て 	 あらわれ て
勝っ て 	 かっ て
泣き 	 なき
負け て 	 まけ て
泣く 	 なく
入る 	 はいる
受領 し て 	 じゅりょう し て
得 た 	 え た
称さ れる 	 しょうさ れる
放映 さ れ た ように 	 ほうえい さ れ た ように
発布 し 	 はっぷ し
選出 する ように なり 	 せんしゅつ する ように なり
受け なく なる ように なっ た 	 うけ なく なる ように なっ た
掘り下げ て 	 ほりさげ て
き 	 き
つ け ましょ う 	 つ け ましょ う
似 て 	 に て
帯び た 	 おび た
確認 でき た 	 かくにん でき た
変更 する 	 へんこう する
隠す 	 かくす
いじくっ て 	 いじくっ て
とり 	 とり
踏ん 	 ふん
やっ て 	 やっ て
すれ 	 すれ
続行 し た 	 ぞっこう し た
み られる 	 み られる
滞在 し 	 たいざい し
触発 さ れ た 	 しょくはつ さ れ た
執筆 し た 	 しっぴつ し た
許さ れ た 	 ゆるさ れ た
入れ た 	 いれ た
言い 	 ことい
選ば れ 	 えらば れ
誘導 し た 	 ゆうどう し た
めぶく 	 めぶく
でき て 	 でき て
接合 さ れ た 	 せつごう さ れ た
感じ なかっ た 	 かんじ なかっ た
運営 する 	 うんえい する
受け た 	 うけ た
続け て 	 つづけ て
戻っ て 	 もどっ て
警告 する 	 けいこく する
構成 さ れる 	 こうせい さ れる
訪問 	 ほうもん
進め られる 	 すすめ られる
済む 	 すむ
所属 し て 	 しょぞく し て
皮肉っ た 	 ひにくっ た
くっつけ た 	 くっつけ た
ゆく 	 ゆく
生きる 	 いきる
確信 し て 	 かくしん し て
持ち込も う 	 もちこも う
外れ た 	 はずれ た
云 える 	 い える
受賞 	 じゅしょう
明け た 	 あけ た
行っ た 	 いっ た
現れ 	 あらわれ
入ら なく なっ て 	 はいら なく なっ て
感じ られ まし た 	 かんじ られ まし た
伸張 し 	 しんちょう し
拡大 し た 	 かくだい し た
注意 さ れ て 	 ちゅうい さ れ て
下ろす 	 おろす
勧め 	 すすめ
一般化 さ せ た 	 いっぱんか さ せ た
暴く 	 あばく
雇う 	 やとう
放球 さ れ た 	 ほうきゅう さ れ た
想像 する 	 そうぞう する
存命 	 ぞんめい
話し て 	 はなし て
記さ れ た 	 きさ れ た
認知 さ れ た 	 にんち さ れ た
起こっ て 	 おこっ て
策定 する 	 さくてい する
派遣 し 	 はけん し
勉強 し なさい 	 べんきょう し なさい
言わ なく て 	 いわ なく て
勉強 する ように なっ た 	 べんきょう する ように なっ た
通わ せ て 	 かよわ せ て
食べ れる 	 たべ れる
沈ま ない 	 しずま ない
悩まさ れ 	 なやまさ れ
陥っ た 	 おちいっ た
解き明かす べき 	 ときあかす べき
違う でしょ う 	 ちがう でしょ う
設置 し た 	 せっち し た
食す 	 しょくす
わたり 	 わたり
繰り広げ 	 くりひろげ
敗れ去る 	 やぶれさる
封じ 	 ふうじ
攻撃 さ せ た 	 こうげき さ せ た
負わ せる 	 おわ せる
成功 し た 	 せいこう し た
倒し て 	 たおし て
離れる 	 はなれる
潜っ て 	 もぐっ て
消し 	 けし
経つ 	 たつ
出現 する 	 しゅつげん する
繰り返す 	 くりかえす
出演 	 しゅつえん
思う 	 おもう
まとめ て 	 まとめ て
書か れ て 	 かか れ て
合併 	 がっぺい
残存 し て 	 ざんぞん し て
響い た 	 ひびい た
発生 する 	 はっせい する
紛糾 し た 	 ふんきゅう し た
終了 し て 	 しゅうりょう し て
参照 	 さんしょう
採用 さ れ て 	 さいよう さ れ て
発生 し た ように 	 はっせい し た ように
放置 する 	 ほうち する
展開 さ れる 	 てんかい さ れる
タッチ し ない 	 たっち し ない
い なかっ た 	 い なかっ た
授かり 	 さずかり
喜ん 	 きん
育てる 	 そだてる
食事 する 	 しょくじ する
わたっ て 	 わたっ て
守る 	 まもる
基づき 	 もとづき
支援 し て 	 しえん し て
至っ て 	 いた って
転じ て 	 てんじ て
呼ぶ ように 	 よぶ ように
出し て 	 だし て
進める 	 すすめる
飾っ た 	 かざっ た
描か れ て 	 えがか れ て
遅れ 	 おくれ
追突 さ れ た 	 ついとつ さ れ た
破損 	 はそん
変身 する ように なる 	 へんしん する ように なる
保証 さ れる 	 ほしょう さ れる
行わ れ ない 	 おこなわ れ ない
指す 	 ゆびす
追加 する 	 ついか する
製造 さ れ た 	 せいぞう さ れ た
含め られる 	 ふくめ られる
分かり づらい 	 わかり づらい
連動 さ せ て 	 れんどう さ せ て
移し 	 うつし
見 	 み
移動 	 いどう
実現 し よう 	 じつげん し よう
理解 し て 	 りかい し て
投げ よう 	 なげ よう
低下 する 	 ていか する
認め て 	 みとめ て
明記 さ れ て 	 めいき さ れ て
由来 する 	 ゆらい する
行う べき だ 	 おこなう べき だ
主張 し て 	 しゅちょう し て
予想 さ れる 	 よそう さ れる
叙述 さ れ て 	 じょじゅつ さ れ て
伸びる 	 のびる
放ち 	 はなち
会い 出来 	 あい でき
思い まし た 	 おもい まし た
つか れ 	 つか れ
だまさ れ 	 だまさ れ
とら れ て 	 とら れ て
販売 する 	 はんばい する
上回る 	 うわまわる
低迷 する 	 ていめい する
下落 する 	 げらく する
予想 し て 	 よそう し て
合体 	 がったい
行か なく て 	 いか なく て
訳注 さ れ た 	 やくちゅう さ れ た
収納 さ れる 	 しゅうのう さ れる
示さ れる 	 しめさ れる
考案 さ れ た 	 こうあん さ れ た
出演 できる 	 しゅつえん できる
眺める 	 ながめる
架かる 	 かかる
思わ せる 	 おもわ せる
し ましょ う 	 し ましょ う
企む 	 たくらむ
残し た 	 のこし た
スカウト する 	 すかうと する
主催 さ れ た 	 しゅさい さ れ た
締結 さ れ た 	 ていけつ さ れ た
展開 する 	 てんかい する
漂う 	 ただよう
につい て 	 につい て
触れ ない 	 ふれ ない
気に入り まし た 	 きにいり まし た
倒れ た 	 たおれ た
看取っ た 	 かんしゅっ た
似通っ て 	 にかよっ て
受け取っ た 	 うけとっ た
細め 	 ほそめ
さ れ た 	 さ れ た
達し 	 たっし
ほころん だ 	 ほころん だ
提唱 し た 	 ていしょう し た
決定 し た 	 けってい し た
実行 し た 	 じっこう し た
失敗 する 	 しっぱい する
伴っ て 	 ともなっ て
縮小 さ れ た 	 しゅくしょう さ れ た
傷つける 	 きずつける
信仰 する 	 しんこう する
触れ て 	 ふれ て
終了 し 	 しゅうりょう し
鳴り響く 	 なりひびく
始める 	 はじめる
ざわつい た 	 ざわつい た
鍛え 	 きたえ
変化 し 	 へんか し
演出 する 	 えんしゅつ する
与え られ て 	 あたえ られ て
及ば なかっ た 	 およば なかっ た
売り上げ た 	 うりあげ た
死亡 する 	 しぼう する
在る 	 ある
合格 できる 	 ごうかく できる
設定 し て 	 せってい し て
指定 さ れ て 	 してい さ れ て
導 ける 	 みちび ける
慕う 	 したう
化し て 	 かし て
出 た 	 で た
置い て 	 おい て
グレ て 	 ぐれ て
飲ん 	 のん
出 たら 	 で たら
し たら 	 し たら
志し 	 こころざしし
希望 し た 	 きぼう し た
押し切っ て 	 おしきっ て
上京 	 じょうきょう
言わ れる ように なっ た 	 いわ れる ように なっ た
探し て 	 さがし て
惹か れ て 	 ひか れ て
入っ て 	 はいっ て
押さえ 込む 	 おさえ こむ
でき た 	 でき た
成る 	 なる
開始 し 	 かいし し
発生 し て 	 はっせい し て
研究 し た 	 けんきゅう し た
引き続き 	 ひきつづき
構築 する 	 こうちく する
提唱 さ れ た 	 ていしょう さ れ た
伝送 する 	 でんそう する
考え られる 	 かんがえ られる
開催 し た 	 かいさい し た
困る 	 こまる
退団 する 	 たいだん する
退団 し た 	 たいだん し た
向け 	 むけ
始め 	 はじめ
対応 する 	 たいおう する
たり 	 たり
脱退 でき ない 	 だったい でき ない
問わ ず 	 とわ ず
入社 し 	 にゅうしゃ し
兼務 し て 	 けんむ し て
引き継い 	 ひきつい
デザイン し 直さ れ て 	 でざいん し なおさ れ て
増やす 	 ふやす
追っ て 	 おっ て
降伏 し た 	 こうふく し た
帰国 	 きこく
裏切っ た 	 うらぎっ た
組織 し て 	 そしき し て
採用 し て 	 さいよう し て
出し切っ て 	 だしきっ て
衰滅 する 	 すいめつ する
添加 し て 	 てんか し て
死滅 さ せ て 	 しめつ さ せ て
醗酵 し ない 	 はっこう し ない
止まり 	 どまり
報じ た 	 ほうじ た
拒否 し た 	 きょひ し た
受ける 	 うける
治っ た 	 なおっ た
経営 し て 	 けいえい し て
もたらし 	 もたらし
呼び込む 	 よびこむ
参加 	 さんか
棄却 し た 	 ききゃく し た
放送 	 ほうそう
からめる 	 からめる
設立 さ れ た 	 せつりつ さ れ た
担当 し て 	 たんとう し て
設立 し た 	 せつりつ し た
担当 	 たんとう
囲ま れ て 	 かこま れ て
展開 し て 	 てんかい し て
尽力 し た 	 じんりょく し た
死に 	 しに
述べ た 	 のべ た
挙げ て 	 あげ て
消え た 	 きえ た
使用 	 しよう
始まる 	 はじまる
採用 さ れる 	 さいよう さ れる
提供 さ れる 	 ていきょう さ れる
画す 	 がす
勤務 し た 	 きんむ し た
担任 し て 	 たんにん し て
利用 し 易い です 	 りよう し やすい です
当てる 	 あてる
戻る 	 もどる
受講 する 	 じゅこう する
発表 し た 	 はっぴょう し た
転がし 	 ころがし
挙げ た 	 あげ た
飼育 する 	 しいく する
調査 し た 	 ちょうさ し た
見つかっ て 	 みつかっ て
感じ ない 	 かんじ ない
改め られ て 	 あらため られ て
測定 し た 	 そくてい し た
記録 する 	 きろく する
用意 さ れ て 	 ようい さ れ て
移る 	 うつる
訪れる 	 おとずれる
紹介 さ れ 	 しょうかい さ れ
つい た 	 つい た
模索 する 	 もさく する
さ れ て 	 さ れ て
おら ず 	 おら ず
驚い た 	 おどろい た
できる ように なり まし た 	 できる ように なり まし た
覆う 	 おおう
確保 し て 	 かくほ し て
構成 する 	 こうせい する
代わっ て 	 かわっ て
行い 	 おこない
演出 し 	 えんしゅつ し
で 	 で
代用 できる 	 だいよう できる
相関 し て 	 そうかん し て
言え ない ようだ 	 いえ ない ようだ
通過 し た 	 つうか し た
反対 し た 	 はんたい し た
製造 さ れ 	 せいぞう さ れ
納入 さ れ た 	 のうにゅう さ れ た
軽視 し て 	 けいし し て
両立 さ れ て 	 りょうりつ さ れ て
近接 し て 	 きんせつ し て
接続 する 	 せつぞく する
色分け さ れ て 	 いろわけ さ れ て
迷う 	 まよう
取り付け られる 	 とりつけ られる
なり たい 	 なり たい
降り注ぎ 	 ふりそそぎ
蓄積 し て 	 ちくせき し て
当選 し まし た 	 とうせん し まし た
遅延 し た 	 ちえん し た
遅らせ て 	 おくらせ て
確定 し て 	 かくてい し て
失い 	 うしない
寄せ 	 よせ
連れ添っ て 	 つれそっ て
調査 する 	 ちょうさ する
発表 し 	 はっぴょう し
持てる 	 もてる
来店 し まし た 	 らいてん し まし た
引き 	 ひき
打ち合っ て 	 うちあっ て
確認 し て 	 かくにん し て
出さ れ た 	 ださ れ た
示さ れ た 	 しめさ れ た
継承 さ れ て 	 けいしょう さ れ て
飽き ませ ん でした 	 あき ませ ん でした
含み 	 ふくみ
み られ ない 	 み られ ない
物語っ て 	 ものがたっ て
象徴 する 	 しょうちょう する
頑張る 	 がんばる
燃える 	 もえる
見 込ん だ 	 み こん だ
上回り 	 かみまわり
減速 し て 	 げんそく し て
後退 	 こうたい
かえ て 	 かえ て
搭載 さ れ た 	 とうさい さ れ た
書か れ た 	 かか れ た
撒く 	 まく
とどまり 	 とどまり
仕舞わ れ た 	 じまいわ れ た
圧倒 し て 	 あっとう し て
叫ば れ て 	 さけば れ て
いっ た 	 いっ た
増える 	 ふえる
埋め 尽くす 	 うめ つくす
取り組 め そう です 	 とりく め そう です
教える 	 おしえる
教わる 	 おそわる
建設 さ れ 	 けんせつ さ れ
廃止 さ れる 	 はいし さ れる
敷き詰める 	 しきつめる
斬る 	 きる
満喫 さ せ て 	 まんきつ さ せ て
いけ て 	 いけ て
移籍 	 いせき
入場 でき ない 	 にゅうじょう でき ない
超え て 	 こえ て
漂着 する 	 ひょうちゃく する
持た ない 	 もた ない
認識 し た 	 にんしき し た
停止 	 ていし
盗む 	 ぬすむ
破壊 さ れ て 	 はかい さ れ て
マーク する 	 まーく する
生み出す 	 うみだす
続き まし た 	 つづき まし た
電話 し て 	 でんわ し て
し まし た 	 し まし た
抑え 	 おさえ
設定 する 	 せってい する
応じ て 	 おうじ て
変更 できる 	 へんこう できる
低減 する 	 ていげん する
備え て 	 そなえ て
用い た 	 もちい た
挙げる 	 あげる
収め た 	 おさめ た
断ら ない 	 ことわら ない
連打 し 	 れんだ し
始まっ た 	 はじまっ た
主催 する 	 しゅさい する
特化 さ れ た 	 とっか さ れ た
指名 する 	 しめい する
破壊 さ れ 	 はかい さ れ
混合 する 	 こんごう する
得 られる 	 え られる
送っ て 	 おくっ て
死去 し た 	 しきょ し た
し よう 	 し よう
現れ た 	 あらわれ た
やめ た 	 やめ た
残さ れ て 	 のこさ れ て
運営 	 うんえい
工夫 さ れ た 	 くふう さ れ た
向ける 	 むける
利用 さ れ 	 りよう さ れ
知っ た 	 しっ た
言い 出し 	 いい だし
言い出す 	 いいだす
意味 し 	 いみ し
光り輝く 	 ひかりかがやく
合格 	 ごうかく
発売 さ れ た 	 はつばい さ れ た
販売 さ れ ませ ん 	 はんばい さ れ ませ ん
帰国 し て 	 きこく し て
苦しめ て 	 くるしめ て
出演 し て 	 しゅつえん し て
戦う 	 たたかう
固め られ た 	 かため られ た
治し て 	 なおし て
伝え た 	 つたえ た
関わら ず 	 かかわら ず
行き ませ ん でした 	 いき ませ ん でした
比べ 	 くらべ
参加 し たい 	 さんか し たい
減る 	 へる
参加 し たく ない 	 さんか し たく ない
答える 	 こたえる
超える 	 こえる
分かっ た 	 わかっ た
公開 	 こうかい
利用 し て 	 りよう し て
陥れ よう 	 おとしいれ よう
堪え ませ ん 	 たえ ませ ん
付い た 	 つい た
拭く 	 ふく
脱脂 する 	 だっし する
配信 さ れる 	 はいしん さ れる
最適化 さ れ た 	 さいてきか さ れ た
さ せる 	 さ せる
使い古さ れ た 	 つかいふるさ れ た
弾圧 し ない 	 だんあつ し ない
分類 さ れる 	 ぶんるい さ れる
い ます 	 い ます
発表 さ れ た 	 はっぴょう さ れ た
満足 し て 	 まんぞく し て
目指し て 	 めざし て
報告 し て 	 ほうこく し て
経過 し て 	 けいか し て
批判 し 	 ひはん し
失っ て 	 うしなっ て
述懐 し て 	 じゅっかい し て
シングル 	 しんぐる
化 さ れ て 	 か さ れ て
備え 	 そなえ
うたう 	 うたう
増し た 	 まし た
変更 さ れ て 	 へんこう さ れ て
短縮 さ れ て 	 たんしゅく さ れ て
接続 する ように なっ た 	 せつぞく する ように なっ た
アップロード し た 	 あっぷろーど し た
貼り付け 	 はりつけ
できる ように し て 	 できる ように し て
書い た 	 かい た
盗撮 し た 	 とうさつ し た
開催 し て 	 かいさい し て
乗っ て 	 のっ て
買っ ちゃい まし た 	 かっ ちゃい まし た
ラインナップ さ れ て 	 らいんなっぷ さ れ て
ミス する 	 みす する
目指し 	 めざし
近付く 	 ちかづく
入手 でき ます 	 にゅうしゅ でき ます
北上 し 	 ほくじょう し
確認 さ れ て 	 かくにん さ れ て
伝承 	 でんしょう
死に際 し 	 しにさい し
去っ て 	 さっ て
迎え 	 むかえ
来 た 	 き た
語ら れる 	 かたら れる
称し て 	 しょうし て
持ち逃げ さ れ ます 	 もちにげ さ れ ます
飛 べ なく し た 	 と べ なく し た
喰らい 	 くらい
壊れ た 	 こわれ た
デビュー 	 でびゅー
潰す 	 つぶす
結婚 する 	 けっこん する
辞し て 	 じし て
売却 し た 	 ばいきゃく し た
効く 	 きく
判定 する 	 はんてい する
誤ら せ て 	 あやまら せ て
生み出し ます 	 うみだし ます
いえ 	 いえ
呼 べる 	 よ べる
有し て 	 ゆうし て
看過 さ れ て 	 かんか さ れ て
あしらっ た 	 あしらっ た
持参 し 	 もちさん し
撮ら せ て 	 とら せ て
いらっしゃい まし た 	 いらっしゃい まし た
採用 し 	 さいよう し
見習い ましょ う 	 みならい ましょ う
独立 し た 	 どくりつ し た
作っ て 	 つくっ て
至ら ない 	 いたら ない
形成 し て 	 けいせい し て
寄与 する 	 きよ する
赴任 する 	 ふにん する
でき ず 	 でき ず
言い渡し た 	 いいわたし た
申し上げ ます 	 もうしあげ ます
丸洗い する 	 まるあらい する
直る 	 なおる
積ん だ 	 つん だ
取り入れ た 	 とりいれ た
指定 さ れ た 	 してい さ れ た
発表 する 	 はっぴょう する
普及 する 	 ふきゅう する
中止 する 	 ちゅうし する
富む 	 とむ
記す 	 きす
勧めし ます 	 すすめし ます
尽き た 	 つき た
移籍 し 	 いせき し
登っ た 	 のぼっ た
合わせ た 	 あわせ た
し やすい 	 し やすい
反対 する 	 はんたい する
かまわ ず 	 かまわ ず
追いかける 	 おいかける
逮捕 さ れる 	 たいほ さ れる
果たし た 	 はたし た
教え た 	 おしえ た
用意 し て 	 ようい し て
書き込ん 	 かきこん
有する 	 ゆうする
脅かし 	 おびやかし
勝利 する 	 しょうり する
続く 	 つづく
完結 し て 	 かんけつ し て
築か れ て 	 きずか れ て
賛成 し ます 	 さんせい し ます
切り離す 	 きりはなす
滅ぼさ れ た 	 ほろぼさ れ た
喋る ように なっ た 	 しゃべる ように なっ た
使用 し て 	 しよう し て
かき 始め 	 かき はじめ
眠り 始め まし た 	 ねむり はじめ まし た
備え付け られ て 	 そなえつけ られ て
認識 し 	 にんしき し
尊重 し 合う 	 そんちょう し あう
たり 得 ない 	 たり え ない
意味 する 	 いみ する
押し て 	 おし て
し ませ ん でした 	 し ませ ん でした
向か ない 	 むか ない
書き加え なければ いけ ない 	 かきくわえ なければ いけ ない
選択 する 	 せんたく する
上昇 し 	 じょうしょう し
低下 	 ていか
好ま ない 	 このま ない
挙げ られる 	 あげ られる
重ねる 	 かさねる
自立 する 	 じりつ する
つとめ た 	 つとめ た
合わ ない 	 あわ ない
なり やすい 	 なり やすい
形成 し た 	 けいせい し た
変化 さ せ 	 へんか さ せ
吹き飛ばし た 	 ふきとばし た
並び 	 ならび
揃え て 	 そろえ て
計算 し た 	 けいさん し た
対応 し た 	 たいおう し た
公開 さ れ た 	 こうかい さ れ た
支払っ て 	 しはらっ て
相当 し て 	 そうとう し て
属す 	 ぞくす
結成 さ れ た 	 けっせい さ れ た
連ね て 	 つらね て
あげ 	 あげ
お茶 し て 	 おちゃ し て
帰り ます 	 かえり ます
隣接 する 	 りんせつ する
占める 	 しめる
飼育 さ れ て 	 しいく さ れ て
比べる 	 くらべる
戦い 	 たたかい
基づい て 	 もとづい て
行なう 	 おこなう
手伝っ て 	 てつだっ て
語る 	 かたる
果たさ せる 	 はたさ せる
突破 し た 	 とっぱ し た
記録 さ れ て 	 きろく さ れ て
聴い た 	 きい た
帰っ て 	 かえっ て
触れる 	 ふれる
中断 さ れ た 	 ちゅうだん さ れ た
逃し て 	 のがし て
投入 し た 	 とうにゅう し た
共有 する 	 きょうゆう する
経営 する 	 けいえい する
振り込ま れ た 	 ふりこま れ た
計上 せ ず 	 けいじょう せ ず
行動 し て 	 こうどう し て
共有 し て 	 きょうゆう し て
認め られ 	 みとめ られ
進め られ て 	 すすめ られ て
勤める 	 つとめる
不足 し 	 ふそく し
埋め た 	 うめ た
異なる 	 ことなる
荒れ 	 あれ
殴ら れ て 	 なぐら れ て
続か ず 	 つづか ず
出し さ れ て 	 だし さ れ て
終了 	 しゅうりょう
出荷 さ れ た 	 しゅっか さ れ た
購入 し た 	 こうにゅう し た
限り ませ ん 	 かぎり ませ ん
計画 さ れ て 	 けいかく さ れ て
落とし て 	 おとし て
出場 し た 	 しゅつじょう し た
抑え た 	 おさえ た
入れ られ て 	 いれ られ て
行わ れ て 	 おこなわ れ て
購入 さ れ た 	 こうにゅう さ れ た
いたし ます 	 いたし ます
デビュー し た 	 でびゅー し た
執る 	 とる
位置 し た 	 いち し た
設立 する 	 せつりつ する
決議 し 	 けつぎ し
成立 する ように なる 	 せいりつ する ように なる
リリース し 	 りりーす し
脱却 する 	 だっきゃく する
変え た 	 かえ た
ある なら 	 ある なら
載せる 	 のせる
寵愛 し 	 ちょうあい し
説得 し て 	 せっとく し て
追う 	 おう
刈る 	 かる
一転 し て 	 いってん し て
転じ 	 てんじ
たれ 	 たれ
進ま ず 	 すす まず
挙げ 	 あげ
絶賛 さ れ た 	 ぜっさん さ れ た
存在 し て 	 そんざい し て
含める 	 ふくめる
見受け られる 	 みうけ られる
促し て 	 うながし て
得る 	 うる
見え て 	 みえ て
語ら れ 	 かたら れ
交わす 	 かわす
就任 し た 	 しゅうにん し た
関係 し て 	 かんけい し て
苦しめ られ た 	 くるしめ られ た
対立 し た 	 たいりつ し た
でき なかっ た 	 でき なかっ た
受け付け て 	 うけつけ て
述べる 	 のべる
代わり 	 かわり
設定 さ れ て 	 せってい さ れ て
小型化 し て 	 こがたか し て
尊重 する 	 そんちょう する
発動 し たく ない らしい 	 はつどう し たく ない らしい
置き換え られ て 	 おきかえ られ て
悩ま せ て 	 なやま せ て
防ぐ 	 ふせぐ
でき ませ ん 	 でき ませ ん
取 らさ れ たく ない 	 と らさ れ たく ない
楽しむ 	 たのしむ
物語る 	 ものがたる
上がり まし た 	 あがり まし た
話し でし た 	 はなし でし た
極限 する 	 きょくげん する
ぼられ 	 ぼられ
楽し め まし た 	 たのし め まし た
滞在 	 たいざい
狙っ て 	 ねらっ て
潜入 し た 	 せんにゅう し た
敷か れ た 	 しか れ た
伝え て 	 つたえ て
なで下ろし て 	 なでおろし て
繰り返し て 	 くりかえし て
検証 する 	 けんしょう する
創刊 する 	 そうかん する
癒え た 	 いえ た
出す 	 だす
制定 する 	 せいてい する
継続 さ せ て 	 けいぞく さ せ て
発見 し て 	 はっけん し て
流れ 始め まし た 	 ながれ はじめ まし た
中止 せ ず 	 ちゅうし せ ず
続け た 	 つづけ た
伴う 	 ともなう
維持 する 	 いじ する
離れ て 	 はなれ て
模っ た 	 もっ た
発売 し て 	 はつばい し て
つ け て 	 つ け て
統一 さ れ て 	 とういつ さ れ て
流れ た 	 ながれ た
亡くなり 	 なくなり
消滅 	 しょうめつ
引き取ら れ た 	 ひきとら れ た
触れ 	 ふれ
述べ て 	 のべ て
通る ように なっ た 	 とおる ように なっ た
主催 し た 	 しゅさい し た
痩せ て 	 やせ て
言わ れ て 	 いわ れ て
寄せ た 	 よせ た
協力 する 	 きょうりょく する
変わら ない 	 かわら ない
認める 	 みとめる
でき ない 	 でき ない
言い 切り 	 いい きり
説明 し た 	 せつめい し た
利益 する 	 りえき する
運転 し て 	 うんてん し て
認め 	 みとめ
命じ られ た 	 めいじ られ た
務める 	 つとめる
記録 さ れる 	 きろく さ れる
宣戦布告 し た 	 せんせんふこく し た
置い た 	 おい た
載せ 	 のせ
掛け た 	 かけ た
知ら れ 	 しら れ
いく 	 いく
高まっ て 	 たかまっ て
一貫 し て 	 いっかん し て
上回り 続ける 	 うわまわり つづける
外出 	 がいしゅつ
提供 する 	 ていきょう する
喜ば れ た 	 よろこば れ た
活用 する 	 かつよう する
持て まし た 	 もて まし た
判明 し て 	 はんめい し て
手がけ て 	 てがけ て
断定 する 	 だんてい する
合流 し て 	 ごうりゅう し て
はみ出 	 はみだ
見せ た 	 みせ た
作り 	 づくり
発信 し て 	 はっしん し て
標準化 する 	 ひょうじゅんか する
進め て 	 すすめ て
散らばっ て 	 ちらばっ て
隠し て 	 かくし て
勧誘 する 	 かんゆう する
視 さ れ て 	 し さ れ て
注文 	 ちゅうもん
冠し た 	 かんし た
搭載 する 	 とうさい する
食べ たら 	 たべ たら
ハチキレ て 	 はちきれ て
果た せ ず 	 はた せ ず
陳謝 し た 	 ちんしゃ し た
両立 し た 	 りょうりつ し た
得 	 とく
開始 	 かいし
寄り切っ て 	 よりきっ て
衝突 し た 	 しょうとつ し た
撮影 し た 	 さつえい し た
明かし た 	 あかし た
混ん 	 まん
確認 し た 	 かくにん し た
予言 し た 	 よげん し た
解釈 さ れ た 	 かいしゃく さ れ た
発売 	 はつばい
読ん 	 よん
伝えし まし た 	 つたえし まし た
なし て 	 なし て
受験 する 	 じゅけん する
失敗 	 しっぱい
浪人 し た 	 ろうにん し た
用意 する 	 ようい する
つけ 	 つけ
完勝 し た 	 かんしょう し た
組成 さ れ 	 そせい さ れ
行き たい 	 いき たい
奪い取る 	 うばいとる
成功 し 	 せいこう し
没収 し た 	 ぼっしゅう し た
アップロード さ れ て 	 あっぷろーど さ れ て
ちなん 	 ちなん
名づけ られ た 	 なづけ られ た
遠ざかっ た 	 とおざかっ た
同居 し て 	 どうきょ し て
検索 する 	 けんさく する
マーク し 	 まーく し
決め ます 	 きめ ます
降り て 	 おり て
き ます 	 き ます
い ない 	 い ない
攻撃 し て 	 こうげき し て
足り ず 	 たり ず
手渡 し て 	 てわた し て
そっ た 	 そっ た
見 やすい 	 み やすい
映 せる 	 うつ せる
保存 する 	 ほぞん する
移動 さ せる 	 いどう さ せる
傷つい 	 きずつい
汚れ 	 よごれ
加え 	 くわえ
追加 さ れ た 	 ついか さ れ た
進学 し 	 しんがく し
卒業 する 	 そつぎょう する
再会 	 さいかい
しっかりし て 	 しっかりし て
説明 	 せつめい
飲み にくい 	 のみ にくい
添え られる 	 そえ られる
足し て 	 たし て
食べる 	 たべる
参加 し た 	 さんか し た
合成 し た 	 ごうせい し た
建設 し よう 	 けんせつ し よう
頓挫 	 とんざ
及ぶ 	 およぶ
入れ 込む 	 いれ こむ
恋愛 し て 	 れんあい し て
交際 する 	 こうさい する
求め て 	 もとめ て
従事 し て 	 じゅうじ し て
やろ う 	 やろ う
生まれ た 	 うまれ た
成人 し た 	 せいじん し た
製作 する ように なる 	 せいさく する ように なる
発売 し 	 はつばい し
置く ように なる 	 おく ように なる
もらっ た 	 もらっ た
試し て 	 ためし て
チェック する 	 ちぇっく する
探し 	 さがし
行こ う 	 いこ う
題し 	 だいし
描い た 	 えがい た
探し た 	 さがし た
考え て 	 かんがえ て
親しま れ て 	 したしま れ て
埋め 	 うめ
見せ て 	 みせ て
離れ た 	 はなれ た
指示 し 	 しじ し
付き まし た 	 つき まし た
専念 し たい 	 せんねん し たい
降板 し 	 こうばん し
退職 し た 	 たいしょく し た
交代 	 こうたい
凝っ て 	 こっ て
流れ出る ように なっ て 	 ながれでる ように なっ て
移っ た よう です 	 うつっ た よう です
ある かも知れ ない 	 ある かもしれ ない
住ん 	 すみん
探究 し 	 たんきゅう し
表現 する 	 ひょうげん する
送っ た 	 おくっ た
反し て 	 はんし て
語っ た 	 かたっ た
かみ あい ませ ん 	 かみ あい ませ ん
潜伏 する 	 せんぷく する
殺到 	 さっとう
刺し た 	 さし た
怯ん だ 	 ひるん だ
自刃 し て 	 じじん し て
果て た 	 はて た
乗り切る 	 のりきる
補強 さ れ 	 ほきょう さ れ
殺し た 	 ころし た
解体 さ れ て 	 かいたい さ れ て
樽詰め さ れ た 	 たるづめ さ れ た
改宗 し て 	 かいしゅう し て
得 られる ように なり 	 え られる ように なり
進む 	 すすむ
発掘 さ れ た 	 はっくつ さ れ た
比定 さ れ て 	 ひてい さ れ て
送り出す 	 おくりだす
たかれ 	 たかれ
ささげ た 	 ささげ た
でき なく なる 	 でき なく なる
表現 さ れる 	 ひょうげん さ れる
過ぎ去っ た 	 すぎさっ た
開催 さ れる ように なり 	 かいさい さ れる ように なり
開催 さ れ て 	 かいさい さ れ て
復活 	 ふっかつ
伝え 	 つたえ
倒し た 	 たおし た
中止 さ せる 	 ちゅうし さ せる
楽しみ 	 たのしみ
呆れる 	 あきれる
特定 し て 	 とくてい し て
望み 	 のぞみ
ライトアップ する 	 らいとあっぷ する
助かり ます 	 たすかり ます
つながっ て 	 つながっ て
書く 	 かく
発揮 し 	 はっき し
低下 さ せる 	 ていか さ せる
併せ て 	 あわせ て
止める 	 とめる
起こる かもしれ ない 	 おこる かもしれ ない
存在 し ない 	 そんざい し ない
紹介 し て 	 しょうかい し て
いか ない 	 いか ない
飲ま ない 	 のま ない
載せ て 	 のせ て
想定 し た 	 そうてい し た
開放 さ れ た 	 かいほう さ れ た
批准 し た 	 ひじゅん し た
接し て 	 せっし て
拡張 できる 	 かくちょう できる
帰属 する 	 きぞく する
論じ た 	 ろんじ た
発行 さ れ た 	 はっこう さ れ た
表し て 	 あらわし て
存在 する 	 そんざい する
放出 さ れ た 	 ほうしゅつ さ れ た
引く 	 ひく
いっ て 	 いっ て
おくる 	 おくる
図っ て 	 ずっ て
笑っ た 	 わらっ た
発見 さ れ ず 	 はっけん さ れ ず
成功 さ せる 	 せいこう さ せる
指摘 さ れ た 	 してき さ れ た
却下 し た 	 きゃっか し た
習っ て 	 ならっ て
説明 さ せ て 	 せつめい さ せ て
欠い た 	 かい た
抗議 する 	 こうぎ する
削除 し 	 さくじょ し
つか ない 	 つか ない
取りやめる よう 	 とりやめる よう
要請 し ます 	 ようせい し ます
間違え なく 	 まちがえ なく
出来る 	 できる
注文 できる 	 ちゅうもん できる
見当たり ませ ん でした 	 みあたり ませ ん でした
組み 	 くみ
成立 し ます 	 せいりつ し ます
逮捕 さ れ 	 たいほ さ れ
検挙 さ れ て 	 けんきょ さ れ て
つながっ た 	 つながっ た
唱え られ 	 となえ られ
化 し て 	 か し て
参加 でき なけれ 	 さんか でき なけれ
劣り 	 おとり
堕ちる 	 おちる
分析 	 ぶんせき
燃え尽き て 	 もえつき て
変わり 	 かわり
提示 し て 	 ていじ し て
働き 	 はたらき
年老い て 	 ねんおい て
築こ う 	 きず こう
試みる 	 こころみる
整っ た 	 ととのっ た
抱え て 	 かかえ て
記録 し た 	 きろく し た
次ぐ 	 じぐ
まい た 	 まい た
入手 出来る 	 にゅうしゅ できる
製造 する 	 せいぞう する
叶 える 	 かな える
運航 さ れ て 	 うんこう さ れ て
変更 さ れ た 	 へんこう さ れ た
指摘 さ れ 	 してき さ れ
達し て 	 たっし て
選ん 	 せんん
無視 し た 	 むし し た
妊娠 し 	 にんしん し
産む 	 うむ
決め まし た 	 きめ まし た
かけ 	 かけ
転送 	 てんそう
変化 し た 	 へんか し た
発生 し た 	 はっせい し た
化し た 	 かし た
救出 する 	 きゅうしゅつ する
呼びかけ て 	 よびかけ て
抜か れ た 	 ぬか れ た
応え て 	 こたえ て
請け負い 	 うけおい
晴れ て 	 はれ て
果たす 	 はたす
合流 し た 	 ごうりゅう し た
さ せ られ て 	 さ せ られ て
加え た 	 くわえ た
わかる 	 わかる
休み たく ない 	 やすみ たく ない
騙し 	 だまし
騙し 続け て 	 だまし つづけ て
しまい 	 しまい
伺う 	 うかがう
こげ なく なっ て 	 こげ なく なっ て
切っ て 	 きっ て
引き出し 	 ひきだし
現行犯逮捕 し た 	 げんこうはんたいほ し た
分断 する 	 ぶんだん する
遠征 し て 	 えんせい し て
征服 し た 	 せいふく し た
緊張 し まし た 	 きんちょう し まし た
リラックス さ せる 	 りらっくす さ せる
呼び戻す 	 よびもどす
適応 する 	 てきおう する
見つけ て 	 みつけ て
覚醒 さ せる 	 かくせい さ せる
計算 し て 	 けいさん し て
待ち 続け て 	 まち つづけ て
出来 まし た 	 でき まし た
卒業 	 そつぎょう
脱会 し た 	 だっかい し た
かけし た 	 かけし た
注文 し ます 	 ちゅうもん し ます
起こり 	 おこり
空転 し て 	 くうてん し て
語っ て 	 かたっ て
好ま れ た 	 このま れ た
属する 	 ぞくする
伝えする 	 つたえする
つづけ て 	 つづけ て
覆わ れ て 	 おおわ れ て
混ぜ 	 まぜ
焼い て 	 やい て
扱わ れ て 	 あつかわ れ て
絞っ た 	 しぼっ た
注目 さ れ 	 ちゅうもく さ れ
築き上げ た 	 きずきあげ た
格納 する 	 かくのう する
摘ん 	 つん
持ち帰り まし た 	 もちかえり まし た
駆け抜け た 	 かけぬけ た
ドラマ 	 どらま
化 さ れ た 	 か さ れ た
騒がせ 	 さわがせ
つけこん だ 	 つけこん だ
うかが え ます 	 うかが え ます
なす 	 なす
詠ま れ て 	 よま れ て
言え 	 いえ
集約 さ れ て 	 しゅうやく さ れ て
扱い せ ず 	 あつかい せ ず
見守っ て 	 みまもっ て
立ち会っ た 	 たちあっ た
座り 	 すわり
購入 する 	 こうにゅう する
説明 さ れ て 	 せつめい さ れ て
絶対 	 ぜったい
視 さ せる 	 し さ せる
読みと れ ます 	 よみと れ ます
入信 し た 	 にゅうしん し た
取り戻す 	 とりもどす
スタート 	 すたーと
広め よう 	 ひろめ よう
旅 し て 	 たび し て
覚え 	 おぼえ
とりつか れ て 	 とりつか れ て
提供 し 	 ていきょう し
おじゃま する 	 おじゃま する
呼び寄せ て 	 よびよせ て
任さ れ 	 まかさ れ
世話 する 	 せわ する
考え 	 かんがえ
移り 	 うつり
住 める よう 	 す める よう
用意 し た 	 ようい し た
採 れる 	 と れる
はやっ て 	 はやっ て
誘っ て 	 さそっ て
捧げる 	 ささげる
向く ように 	 むく ように
装っ て 	 よそおっ て
現れる 	 あらわれる
好ん だ 	 このん だ
誇っ た 	 ほこっ た
見つかっ た 	 みつかっ た
ついてまわり ます 	 ついてまわり ます
主張 	 しゅちょう
参加 できる 	 さんか できる
数値化 し た 	 すうちか し た
承認 し 	 しょうにん し
結ん だ 	 むすん だ
報道 し た 	 ほうどう し た
完成 	 かんせい
知ら れ て 	 しら れ て
研究 する 	 けんきゅう する
実施 せ らる べく 	 じっし せ らる べく
有す 	 ゆうす
排除 さ れ て 	 はいじょ さ れ て
結ん 	 むすん
接近 し た 	 せっきん し た
たまり ませ ん 	 たまり ませ ん
変わっ た 	 かわっ た
受け ず 	 うけ ず
死亡 し て 	 しぼう し て
思わ せ て 	 おもわ せ て
こと し ない 	 こと し ない
流れる 	 ながれる
設定 し た 	 せってい し た
招集 さ れ た 	 しょうしゅう さ れ た
失点 する 	 しってん する
見せ られ ず 	 みせ られ ず
喫し た 	 きっし た
設置 さ れ て 	 せっち さ れ て
熟練 し た 	 じゅくれん し た
要求 し て 	 ようきゅう し て
聞 け ない 	 き け ない
なり ませ ん 	 なり ませ ん
違っ た 	 ちがっ た
つれ て 	 つれ て
使役 さ れ て 	 しえき さ れ て
掛け合わせ て 	 かけあわせ て
作出 さ れ た 	 さくしゅつ さ れ た
操る 	 あやつる
負け られ ない 	 まけ られ ない
関わっ た 	 かかわっ た
み て 	 み て
調べ て 	 しらべ て
集まり 始め 	 あつまり はじめ
続ける 	 つづける
葬る ような 	 ほうむる ような
刻印 さ れ 続け て 	 こくいん さ れ つづけ て
加え て 	 くわえ て
生じ 始め た 	 しょうじ はじめ た
上映 する 	 じょうえい する
増加 し 	 ぞうか し
置き 	 おき
かえ 	 かえ
指摘 し 	 してき し
リストラ さ れ 	 りすとら さ れ
入れ替える 	 いれかえる
生じ て 	 しょうじ て
訴え て 	 うったえ て
誘わ れ 	 さそわ れ
来し て 	 きし て
蘇っ た 	 よみがえっ た
達する 	 たっする
録音 でき ない 	 ろくおん でき ない
おこなっ て 	 おこなっ て
来店 	 らいてん
起こし て 	 おこし て
再生 さ せる 	 さいせい さ せる
付加 さ れ て 	 ふか さ れ て
貫く 	 つらぬく
冠し て 	 かんし て
放送 さ れる ような 	 ほうそう さ れる ような
異なり 	 ことなり
感じ させる 	 かんじ させる
進撃 する 	 しんげき する
勇戦 し た 	 ゆうせん し た
開発 する 	 かいはつ する
上陸 し た 	 じょうりく し た
戦死 し 	 せんし し
負傷 し た 	 ふしょう し た
映る 	 うつる
称さ れ た 	 しょうさ れ た
割拠 し て 	 かっきょ し て
詐称 し た 	 さしょう し た
叩い て 	 たたい て
休む 	 やすむ
活動 する 	 かつどう する
離陸 	 りりく
脱落 し 	 だつらく し
挟まっ た 	 はさまっ た
おこら ず 	 おこら ず
提案 し て 	 ていあん し て
出所 し た 	 でどころ し た
行い まし た 	 おこない まし た
選定 さ れ て 	 せんてい さ れ て
会合 	 かいごう
燃え て 	 もえ て
119番 し た 	 １１９ばん し た
収納 さ れ て 	 しゅうのう さ れ て
かける 	 かける
頼ん 	 よちん
響き 	 ひびき
願いし た 	 ねがいし た
参戦 し た 	 さんせん し た
行なわ れる 	 おこなわ れる
振り 	 ふり
抜い た 	 ぬい た
飛ばす 	 とばす
料理 し て 	 りょうり し て
白骨化 し た 	 はっこつか し た
調べ た 	 しらべ た
捜査 し 	 そうさ し
厭わ ない 	 いやわ ない
対比 さ せ て 	 たいひ さ せ て
コメント し て 	 こめんと し て
借り た 	 かり た
傾い た 	 かたむい た
風化 し た 	 ふうか し た
構成 さ れ て 	 こうせい さ れ て
開店 	 かいてん
噴出 し た 	 ふんしゅつ し た
よれ 	 よれ
安置 し 	 あんち し
動員 し 	 どういん し
手に入れ た 	 てにいれ た
消灯 する 	 しょうとう する
収集 し 	 しゅうしゅう し
管理 する 	 かんり する
取り組ん 	 とりくん
苦戦 する 	 くせん する
認識 し て 	 にんしき し て
分かれ て 	 わかれ て
名乗っ た 	 なのっ た
突入 し た 	 とつにゅう し た
追いやら れ て 	 おいやら れ て
描い て 	 えがい て
飛ん 	 ひん
さ れ にくい 	 さ れ にくい
応じる 	 おうじる
委ね られ て 	 ゆだね られ て
許さ ない 	 ゆるさ ない
許し 	 ゆるし
リリース し た 	 りりーす し た
測定 し 	 そくてい し
引き起こす 	 ひきおこす
気づい て 	 きづい て
まく 	 まく
所属 する 	 しょぞく する
警告 し た 	 けいこく し た
荒れ ず 	 あれ ず
摘発 す べき 	 てきはつ す べき
摘発 し た 	 てきはつ し た
合わせる 	 あわせる
なり ます 	 なり ます
表す 	 あらわす
取れ た 	 とれ た
伝わる 	 つたわる
記載 さ れ て 	 きさい さ れ て
育て られ た 	 そだて られ た
載っ た 	 のっ た
運ん 	 はこん
収まら ず 	 おさまら ず
変わる 	 かわる
突か れ 	 つか れ
カバー 出来 ず 	 かばー でき ず
目立ち 	 めりっち
助け られ 	 たすけ られ
競り 	 せり
勝た れ て 	 かた れ て
奪わ れ て 	 うばわ れ て
行き たく なる 	 いき たく なる
設け て 	 もうけ て
要求 し 	 ようきゅう し
挑発 	 ちょうはつ
言わ れ た 	 いわ れ た
感じ させ 	 かんじ させ
くれ た 	 くれ た
勤め 	 つとめ
勤め て 	 つとめ て
反映 し て 	 はんえい し て
変化 し て 	 へんか し て
踏まえる 	 ふまえる
作出 し 続け て 	 さくしゅつ し つづけ て
主催 し て 	 しゅさい し て
言わ ざるをえ ませ ん 	 いわ ざるをえ ませ ん
拒否 し て 	 きょひ し て
見抜き 	 みぬき
共演 し て 	 きょうえん し て
示し た 	 しめし た
決め 	 きめ
披露 する 	 ひろう する
保存 し た 	 ほぞん し た
いき 	 いき
対談 	 たいだん
歌唱 	 かしょう
上京 し て 	 じょうきょう し て
分岐 し 	 ぶんき し
掲載 さ れ て 	 けいさい さ れ て
残し て 	 のこし て
使い にくい 	 つかい にくい
断ら れる 	 ことわら れる
き け ない 	 き け ない
送ら れ て 	 おくら れ て
映さ れ て 	 うつさ れ て
取っ て 	 とっ て
略 さ れる 	 りゃく さ れる
嫌わ れ て 	 きらわ れ て
言い たいです 	 いい たいです
開い て 	 ひらい て
頂き たい 	 いただき たい
閉鎖 さ れる 	 へいさ さ れる
引退 し た 	 いんたい し た
強化 さ れ た 	 きょうか さ れ た
博し 	 はくし
立て 	 たて
でき 	 でき
保証 する 	 ほしょう する
挑む 	 いどむ
粛清 し て 	 しゅくせい し て
掌握 し 	 しょうあく し
築く 	 きずく
見捨て ない 	 みすて ない
戻っ た 	 もどっ た
はっきりし て 	 はっきりし て
指揮 さ せ たら 	 しき さ せ たら
捕らえ られ 	 とらえ られ
帰還 し た 	 きかん し た
欠落 	 けつらく
犯し て 	 おかし て
行わ れ 	 おこなわ れ
復帰 さ れ た 	 ふっき さ れ た
引き渡さ れ た 	 ひきわたさ れ た
上映 し ます 	 じょうえい し ます
設立 	 せつりつ
開放 し 	 かいほう し
誘導 する 	 ゆうどう する
進め た 	 すすめ た
ののしっ た 	 ののしっ た
企画 し て 	 きかく し て
展開 し 始め た そうです 	 てんかい し はじめ た そうです
撃破 し て 	 げきは し て
捕らえ た 	 とらえ た
報道 さ れ て 	 ほうどう さ れ て
棲ん 	 すん
会っ たら 	 あっ たら
取り込ま れ て 	 とりこま れ て
被わ れる 	 おおわ れる
深める 	 ふかめる
定め て 	 さだめ て
利用 する ように 	 りよう する ように
搭載 さ れ て 	 とうさい さ れ て
化 	 か
記憶 する 	 きおく する
了承 する 	 りょうしょう する
示さ れ 	 しめさ れ
認め られる 	 みとめ られる
排除 する 	 はいじょ する
一致 し ない 	 いっち し ない
接する 	 せっする
兼任 し て 	 けんにん し て
クリック する 	 くりっく する
表示 さ れる 	 ひょうじ さ れる
現し 始め た 	 げんし はじめ た
伝える べき 	 つたえる べき
悩ま せる 	 なやま せる
携わっ た 	 たずさわっ た
纏め た 	 まとめ た
命令 	 めいれい
実行 さ れ 	 じっこう さ れ
す べき 	 す べき
契約 し 	 けいやく し
かざっ て 	 かざっ て
出版 さ れ て 	 しゅっぱん さ れ て
装備 	 そうび
叩き出す 	 たたきだす
あえぐ 	 あえぐ
放送 し なかっ た 	 ほうそう し なかっ た
連発 	 れんぱつ
さらわ れ 	 さらわ れ
売ら れ 	 うら れ
過ごす 	 すごす
流れ 	 ながれ
変える 	 かえる
走ら せる 	 はしら せる
認め 合い 	 みと めあい
当選 	 とうせん
評価 できる 	 ひょうか できる
希望 する 	 きぼう する
分かる 	 わかる
取り付け 	 とりつけ
整備 する 	 せいび する
一変 し 	 いっぺん し
集まっ た 	 あつまっ た
いっ たら 	 いっ たら
結ば れ た 	 むすば れ た
運転 さ れ て 	 うんてん さ れ て
運転 さ れる 	 うんてん さ れる
とれ ちゃい ます 	 とれ ちゃい ます
作っ た 	 つくっ た
定め られ て 	 さだめ られ て
存続 し て 	 そんぞく し て
へ 	 へ
移籍 し た 	 いせき し た
やられ た 	 やられ た
発し 	 はっし
なっ 	 なっ
盛り込ま れ て 	 もりこま れ て
閉ざさ れ た 	 とざさ れ た
押しつぶさ れる 	 おしつぶさ れる
眠る 	 ねむる
持たさ れる 	 もたさ れる
わかっ て 	 わかっ て
取り除く 	 とりのぞく
つき まし た 	 つき まし た
利用 する 	 りよう する
増え て 	 ふえ て
邪魔 さ れる 	 じゃま さ れる
切り抜け 	 きりぬけ
よみがえら せ た 	 よみがえら せ た
標記 さ れ て 	 ひょうき さ れ て
創刊 し た 	 そうかん し た
よこし て 	 よこし て
き まし た 	 き まし た
食べ たく なる 	 たべ たく なる
落ち 	 おち
駆け落ち し よう 	 かけおち し よう
溢れ て 	 あふれ て
扱い 	 あつかい
観測 できる 	 かんそく できる
扱う 	 あつかう
話しかけ て 	 はなしかけ て
形成 さ れ た 	 けいせい さ れ た
掘り 	 ほり
つくさ れる 	 つくさ れる
行 え ませ ん 	 おこな え ませ ん
経験 	 けいけん
倒す 	 たおす
なくなる 	 なくなる
管理 し て 	 かんり し て
死ん 	 しん
誕生 する 	 たんじょう する
絶滅 する 	 ぜつめつ する
亡くし 	 なくし
聞かさ れ 続け られ て 	 きかさ れ つづけ られ て
持ち 続ける 	 もち つづける
続け 	 つづけ
採る 	 とる
断り づらく し て 	 ことわり づらく し て
放置 さ れ て 	 ほうち さ れ て
視 さ れる ように なり まし た 	 し さ れる ように なり まし た
開始 し た 	 かいし し た
歌う 	 うたう
値上げ する 	 ねあげ する
変更 さ れる 	 へんこう さ れる
もらう 	 もらう
もら え た 	 もら え た
認め られ た ような 	 みとめ られ た ような
寄せ られ た 	 よせ られ た
集め て 	 あつめ て
紹介 	 しょうかい
使用 さ れ なかっ た 	 しよう さ れ なかっ た
経過 する 	 けいか する
分布 する 	 ぶんぷ する
到達 する 	 とうたつ する
解決 し て 	 かいけつ し て
努力 し て 	 どりょく し て
賭け なければ なら ない 	 かけ なければ なら ない
在籍 する 	 ざいせき する
破裂 し た 	 はれつ し た
治 せる 	 なお せる
治 せ なかっ た 	 なお せ なかっ た
導入 する 	 どうにゅう する
知り合っ た 	 しりあっ た
組む 	 くむ
提出 し て 	 ていしゅつ し て
集まっ て 	 あつまっ て
回復 する 	 かいふく する
合せ て 	 あわせ て
見 直さ れ て 	 み なおさ れ て
にぎわう 	 にぎわう
勝利 し た 	 しょうり し た
おすすめ し ない 	 おすすめ し ない
変更 し た 	 へんこう し た
抜い て 	 ぬい て
踏まえ た 	 ふまえ た
含む 	 ふくむ
充実 し て 	 じゅうじつ し て
つかっ た 	 つかっ た
い け ます 	 い け ます
異なっ た 	 ことなっ た
統合 さ せ た 	 とうごう さ せ た
述べ まし た 	 のべ まし た
進み 	 すすみ
残さ れ た 	 のこさ れ た
いこ う 	 いこ う
上げ た 	 あげ た
予定 し て 	 よてい し て
取りやめ た 	 とりやめ た
加入 し て 	 かにゅう し て
関わる 	 かかわる
拒否 さ れ て 	 きょひ さ れ て
発売 さ れ 	 はつばい さ れ
就く 	 つく
加盟 し て 	 かめい し て
分け て 	 わけ て
構成 し 	 こうせい し
決め られ た 	 きめ られ た
跳躍 し て 	 ちょうやく し て
移動 する 	 いどう する
説明 する 	 せつめい する
沈降 し 	 ちんこう し
出来 て 	 でき て
残っ て 	 のこっ て
突入 する 	 とつにゅう する
伸び悩ん だ 	 のびなやん だ
待っ て 	 まっ て
すすめ て 	 すすめ て
提供 し ます 	 ていきょう し ます
自動化 し たい 	 じどうか し たい
長生き し た 	 ながいき し た
稼ぎ 	 かせぎ
供養 する 	 くよう する
保護 さ れ 	 ほご さ れ
引き渡さ れ て 	 ひきわたさ れ て
襲っ て 	 おそっ て
渦巻く 	 うずまきく
リンク し 	 りんく し
観測 し た 	 かんそく し た
目立っ た 	 めだっ た
出来 なかっ た 	 でき なかっ た
クリア し て 	 くりあ し て
わかっ た 	 わかっ た
名乗る 	 なのる
割り出し 	 わりだし
掲載 し て 	 けいさい し て
プレイ し た 	 ぷれい し た
すぎ て 	 すぎ て
発展 さ せ た 	 はってん さ せ た
入門 	 にゅうもん
予約 し 	 よやく し
決め て 	 きめ て
見つけ た 	 みつけ た
占拠 さ れ 	 せんきょ さ れ
建設 さ れ た 	 けんせつ さ れ た
壊滅 する 	 かいめつ する
い まし た 	 い まし た
把握 し て 	 はあく し て
活かす 	 いかす
発表 し て 	 はっぴょう し て
夭折 	 ようせつ
紹介 する 	 しょうかい する
運営 し て 	 うんえい し て
停止 し 	 ていし し
解体 さ れ た 	 かいたい さ れ た
開始 さ れ 	 かいし さ れ
延長 さ れ た 	 えんちょう さ れ た
聞か なきゃ だめ だ 	 きか なきゃ だめ だ
奔走 する 	 ほんそう する
追わ れ 	 おわ れ
消える 	 きえる
休ん 	 やすん
崩さ なかっ た 	 くずさ なかっ た
廃止 さ れ 	 はいし さ れ
委託 さ れる 	 いたく さ れる
生活 する 	 せいかつ する
派遣 さ れ て 	 はけん さ れ て
配し た 	 はいし た
聞き 	 きき
配置 する 	 はいち する
出来 ない 	 でき ない
流し て 	 ながし て
制し て 	 せいし て
導い た 	 みちびい た
騎乗 し て 	 きじょう し て
保有 する 	 ほゆう する
続い た 	 つづい た
出 まし た 	 で まし た
入港 する 	 にゅうこう する
座礁 し た 	 ざしょう し た
自殺 し た 	 じさつ し た
結びつき 	 むすびつき
視 する 	 し する
作り上げ た 	 つくりあげ た
決意 し て 	 けつい し て
整え て 	 ととのえ て
徴発 し た 	 ちょうはつ し た
起こっ た 	 おこっ た
下向 し て 	 げこう し て
努め て 	 つとめ て
分布 し て 	 ぶんぷ し て
反発 する 	 はんぱつ する
引き続い て 	 ひきつづい て
規制 する 	 きせい する
上がっ て 	 あがっ て
送信 さ れ て 	 そうしん さ れ て
撃墜 し た 	 げきつい し た
命中 	 めいちゅう
臨 め た 	 のぞ め た
感動 	 かんどう
行き たいです 	 いき たいです
設立 さ れ 	 せつりつ さ れ
務め て 	 つとめ て
因ん 	 ちなみん
名付け られ た 	 なづけ られ た
発足 し た 	 ほっそく し た
検討 する 	 けんとう する
課金 する 	 かきん する
炒め 	 いため
入ってい て 	 はいってい て
反映 さ せ た 	 はんえい さ せ た
公開 する 	 こうかい する
提携 し て 	 ていけい し て
連動 する 	 れんどう する
公開 し た 	 こうかい し た
迫る 	 せまる
抱く 	 いだく
得 て 	 とく て
貫通 できる 	 かんつう できる
私語 	 しご
見受け られ た 	 みうけ られ た
たのし め まし た 	 たのし め まし た
定め た 	 さだめ た
従う べき 	 したがう べき
渋っ て 	 しぶっ て
押さ れる 	 おさ れる
担う 	 になう
調節 できる 	 ちょうせつ できる
思 え ない 	 おも え ない
富ん だ 	 とん だ
満足 でき まし た 	 まんぞく でき まし た
通し て 	 とおし て
告げる 	 つげる
驚い て 	 おどろい て
過ごし た 	 すごし た
実現 する 	 じつげん する
確立 さ れる 	 かくりつ さ れる
化学合成 さ れる ように なる 	 かがくごうせい さ れる ように なる
開発 さ れ た 	 かいはつ さ れ た
伝わっ た 	 つたわっ た
捕え られ た 	 とらえ られ た
隠れ ず 	 かくれ ず
見 やすく なっ た 	 み やすく なっ た
実現 し た 	 じつげん し た
認める ように なる 	 みとめる ように なる
譲受 し た 	 ゆずりうけ し た
飛ん だ 	 とん だ
復讐 する べく 	 ふくしゅう する べく
呼ば れ た 	 よば れ た
話す 	 はなす
生き 	 いき
変わり ます 	 かわり ます
会談 し た 	 かいだん し た
し たい 	 し たい
所蔵 し て 	 しょぞう し て
持ってい ける 	 もって いける
創設 さ れ た 	 そうせつ さ れ た
忍耐 さ れ て 	 にんたい さ れ て
執っ て 	 とっ て
砲撃 し 	 ほうげき し
指し て 	 さし て
果たし 	 はたし
復帰 し た 	 ふっき し た
放映 さ れ て 	 ほうえい さ れ て
解説 する 	 かいせつ する
移転 し た 	 いてん し た
訪問 し た 	 ほうもん し た
思い切っ て 	 おもいきっ て
口コミ し ちゃい ます 	 くちこみ し ちゃい ます
詰め て 	 つめ て
送る 	 おくる
あたる 	 あたる
求め 	 もとめ
提訴 し て 	 ていそ し て
及ん だ 	 およん だ
願い 	 ねがい
でる 	 でる
バント し た 	 ばんと し た
送球 し て 	 そうきゅう し て
生還 し 	 せいかん し
逆転 	 ぎゃくてん
勝ち し た 	 がち し た
降板 し た 	 こうばん し た
ヒアリング する 	 ひありんぐ する
稼働 する 	 かどう する
停止 する 	 ていし する
結婚 し たい 	 けっこん し たい
受講 し まし た 	 じゅこう し まし た
まとめ た 	 まとめ た
併記 し て 	 へいき し て
帰る 	 かえる
出演 し 	 しゅつえん し
心配 し ない 	 しんぱい し ない
こなし て 	 こなし て
し ます 	 し ます
入り 過ぎ 	 いり すぎ
落とし 	 おとし
切っ 	 きっ
開設 さ れ た 	 かいせつ さ れ た
見舞う 	 みまう
戦闘 	 せんとう
聞く 	 きく
聞こえる 	 きこえる
手がけ た 	 てがけ た
携わっ て 	 たずさわっ て
果たし て 	 はたし て
規定 さ れ た 	 きてい さ れ た
来 	 らい
思っ ちゃい ます 	 おもっ ちゃい ます
新設 さ れ た 	 しんせつ さ れ た
出馬 し 	 しゅつば し
行き まし たー 	 いき まし たー
展開 し た 	 てんかい し た
掲載 し た 	 けいさい し た
判明 し まし た 	 はんめい し まし た
開始 できる 	 かいし できる
痛め て 	 いため て
恵まれ ず 	 めぐまれ ず
略奪 する 	 りゃくだつ する
与え て 	 あたえ て
作成 し た 	 さくせい し た
閉鎖 さ れ た 	 へいさ さ れ た
懇願 し た 	 こんがん し た
断ら れ て 	 ことわら れ て
慣れ ない 	 なれ ない
飾る 	 かざる
帰ら ぬ 	 かえら ぬ
撮り 続ける 	 とり つづける
取得 し て 	 しゅとく し て
走る 	 はしる
感心 し た 	 かんしん し た
上げ られ た 	 あげ られ た
継続 する 	 けいぞく する
記載 し て 	 きさい し て
限ら れ た 	 かぎら れ た
感じ でき まし た 	 かんじ でき まし た
開発 し 	 かいはつ し
司る 	 つかさどる
選定 さ れ た 	 せんてい さ れ た
廃止 さ れ た 	 はいし さ れ た
討つ ように 	 うつ ように
命令 し た 	 めいれい し た
栄え た 	 さかえ た
掲載 さ れ た 	 けいさい さ れ た
代表 する 	 だいひょう する
向上 さ せる 	 こうじょう さ せる
高め られ 	 たかめ られ
期待 でき ます 	 きたい でき ます
あれ 	 あれ
チェック し て 	 ちぇっく し て
追い込も う 	 おいこも う
使わ なく なっ た 	 つかわ なく なっ た
歌い 	 うたい
流し ます 	 ながし ます
非難 し て 	 ひなん し て
転換 し 	 てんかん し
し なかっ た 	 し なかっ た
使い込ま れ た 	 つかいこま れ た
高跳び する 	 たかとび する
確認 さ れ まし た 	 かくにん さ れ まし た
売却 さ れる 	 ばいきゃく さ れる
起こり にくい 	 おこり にくい
扱い やすい 	 あつかい やすい
求め られる 	 もとめ られる
好ん 	 すん
言い ませ ん 	 いい ませ ん
思え ます 	 おもえ ます
建て られ て 	 たて られ て
荒れ た 	 あれ た
驚嘆 し て 	 きょうたん し て
書き入れる 	 かきいれる
スタート する 	 すたーと する
実施 さ れる 	 じっし さ れる
顔 せ ず 	 かお せ ず
惚れ する 	 ぼれ する
借り換える 	 かりかえる
開始 し まし た 	 かいし し まし た
達成 	 たっせい
苦しん だ 	 くるしん だ
獲得 する 	 かくとく する
上向き 始め た 	 うわむき はじめ た
閉ざし て 	 とざし て
開く 	 ひらく
撮影 し よう 	 さつえい し よう
妨害 	 ぼうがい
経っ た 	 たっ た
発言 し た 	 はつげん し た
出る ように 	 でる ように
言わ れ 	 いわ れ
精通 する 	 せいつう する
潜む 	 もぐむ
限ら れる 	 かぎら れる
巡回 する 	 じゅんかい する
通過 	 つうか
落ち着い て 	 おちつい て
発行 し 	 はっこう し
あら ぬ 	 あら ぬ
さける 	 さける
特定 さ れる 	 とくてい さ れる
伏せ て 	 ふせ て
活躍 する 	 かつやく する
応援 し よう 	 おうえん し よう
駆けつけ た 	 かけつけ た
固定 する 	 こてい する
醸し出し て 	 かもしだし て
任せ て 	 まかせ て
着目 し た 	 ちゃくもく し た
認め ませ ん でした 	 みとめ ませ ん でした
認定 	 にんてい
襲わ れ 	 おそわ れ
合流 	 ごうりゅう
創刊 さ れ 	 そうかん さ れ
増やし て 	 ふやし て
扱っ て 	 あつかっ て
転落 し た 	 てんらく し た
しかっ た です 	 しかっ た です
行き来 できる 	 ゆきき できる
誕生 	 たんじょう
結び 	 むすび
費やし て 	 ついやし て
発見 でき て 	 はっけん でき て
移転 する 	 いてん する
回っ て 	 かいっ て
呼ん 	 よん
仰げ 	 あおげ
尊 し 	 とうと し
贈る 	 おくる
歌わ れ て 	 うたわ れ て
失格 	 しっかく
晴れる 	 はれる
安心 でき まし た 	 あんしん でき まし た
信奉 する 	 しんぽう する
降臨 し た 	 こうりん し た
滅ん だ 	 ほろん だ
憐れむ 	 あわれむ
記し て 	 きし て
取り戻し た 	 とりもどし た
動き ます 	 うごき ます
かかっ た 	 かかっ た
強調 し た 	 きょうちょう し た
投げ 出し て 	 なげ だし て
再会 し 	 さいかい し
告白 する 	 こくはく する
詠ま れ た 	 よま れ た
共生 する 	 きょうせい する
違っ て 	 ちがっ て
喋ら ない 	 しゃべら ない
知ら れる 	 しら れる
入る ように なっ て 	 はいる ように なっ て
研修 する 	 けんしゅう する
発表 さ れ まし た 	 はっぴょう さ れ まし た
限り 	 かぎり
生き た 	 いき た
頂き まし た 	 いただき まし た
昇進 し 	 しょうしん し
評価 さ れ て 	 ひょうか さ れ て
つき そう です 	 つき そう です
喰らっ た 	 くらっ た
バウンド する 	 ばうんど する
つん だ 	 つん だ
住む ように なる 	 すむ ように なる
表記 する 	 ひょうき する
捕まえる 	 つかまえる
つながる 	 つながる
信じ られ て 	 しんじ られ て
回ろ う 	 かいろ う
操作 でき 	 そうさ でき
動く 	 うごく
占め て 	 しめ て
認め た 	 みとめ た
潰さ れ て 	 つぶさ れ て
飛び込ん 	 とびこん
取り 	 とり
入っ 	 いっ
引っ張り 込も う 	 ひっぱり こも う
口答え し 	 くちごたえ し
捺染 し て 	 なっせん し て
捺染 し た 	 なっせん し た
発見 し た 	 はっけん し た
倒さ れ た 	 たおさ れ た
達成 し 	 たっせい し
継い だ 	 つい だ
結婚 し た 	 けっこん し た
リニューアル し た らしく 	 りにゅーある し た らしく
マッチ し て 	 まっち し て
引き まし た 	 ひき まし た
没し た 	 ぼっし た
公表 し て 	 こうひょう し て
模倣 さ れる 	 もほう さ れる
頂 け たら 	 いただ け たら
試聴 	 しちょう
いただく 	 いただく
不足 し て 	 ふそく し て
発揮 でき ない 	 はっき でき ない
出没 し て 	 しゅつぼつ し て
公開 さ れ て 	 こうかい さ れ て
確認 でき なかっ た 	 かくにん でき なかっ た
駐屯 する 	 ちゅうとん する
刊行 し た 	 かんこう し た
授ける 	 さずける
生え 	 はえ
押し上げ た 	 おしあげ た
充電 する 	 じゅうでん する
移築 し た 	 いちく し た
現存 する 	 げんそん する
想定 さ れ て 	 そうてい さ れ て
引き離さ れ た 	 ひきはなさ れ た
語り継ぎ たい 	 かたりつぎ たい
アクセス し やすい よう 	 あくせす し やすい よう
指示 	 しじ
掃除 する 	 そうじ する
締め て 	 しめ て
定め られ た 	 さだめ られ た
出し 	 だし
感じる 	 かんじる
動き出し た 	 うごきだし た
生まれる 	 うまれる
設定 さ れ た 	 せってい さ れ た
理解 すれ 	 りかい すれ
広まっ た 	 ひろまっ た
会い 	 あい
交換 し た 	 こうかん し た
亡くなっ た 	 なくなっ た
帰化 し て 	 きか し て
積ん 	 つん
恵まれ て 	 めぐまれ て
置か れ た 	 おか れ た
言わ れ まし た 	 いわ れ まし た
選別 し 	 せんべつ し
繰り返し ます 	 くりかえし ます
起こる 	 おこる
悪化 し て 	 あっか し て
拒否 する 	 きょひ する
ビックリ し まし た 	 びっくり し まし た
賞賛 さ れ 	 しょうさん さ れ
実在 し ない 	 じつざい し ない
気付か ず 	 きづか ず
描写 し て 	 びょうしゃ し て
取り出す 	 とりだす
食える 	 くえる
停止 し た 	 ていし し た
急発進 し 	 きゅうはっしん し
衝突 する 	 しょうとつ する
帰属 し ます 	 きぞく し ます
確定 	 かくてい
後悔 し ます 	 こうかい し ます
制御 し き れ て 	 せいぎょ し き れ て
起こし やすい 	 おこし やすい
ぶつかり 	 ぶつかり
判断 し 	 はんだん し
満たす 	 みたす
告発 する 	 こくはつ する
110番通報 し た 	 １１０ばんつうほう し た
浸水 し 	 しんすい し
傾斜 し た 	 けいしゃ し た
採用 し た 	 さいよう し た
当てはまる 	 あてはまる
評価 し た 	 ひょうか し た
見逃し た 	 みのがし た
検索 すれ 	 けんさく すれ
見 れ ます 	 み れ ます
発行 する 	 はっこう する
願いし まし た 	 ねがいし まし た
めぐり 	 めぐり
対立 し て 	 たいりつ し て
緊張 せ ず 	 きんちょう せ ず
伝え られ まし た 	 つたえ られ まし た
直結 する 	 ちょっけつ する
展開 	 てんかい
チェック す べく 	 ちぇっく す べく
寄っ て 	 よっ て
受け入れ て 	 うけいれ て
散乱 し た 	 さんらん し た
片づけ 	 かたづけ
参加 し なかっ た 	 さんか し なかっ た
操作 できる 	 そうさ できる
たどりつ ける ように 	 たどりつ ける ように
重ね まし た 	 かさね まし た
滅亡 し た 	 めつぼう し た
謝罪 し ます 	 しゃざい し ます
装備 さ れ て 	 そうび さ れ て
残っ た 	 のこっ た
論じる ように なっ た 	 ろんじる ように なっ た
侵入 し た 	 しんにゅう し た
襲わ れ た 	 おそわ れ た
行き やすい 	 いき やすい
買い付ける 	 かいつける
ちなん だ 	 ちなん だ
遭っ た 	 あっ た
み られ て 	 み られ て
挑戦 する 	 ちょうせん する
いか ず 	 いか ず
感じ て 	 かんじ て
テスト さ れ て 	 てすと さ れ て
実行 する 	 じっこう する
はっきりさ せ たく て 	 はっきりさ せ たく て
リフレッシュ する 	 りふれっしゅ する
促す 	 うながす
見 られ た 	 み られ た
破却 さ れ た 	 はきゃく さ れ た
残る 	 のこる
実施 せ ず 	 じっし せ ず
支給 し 	 しきゅう し
勤め た 	 つとめ た
出場 	 しゅつじょう
閉じ た 	 とじ た
すっとばし て 	 すっとばし て
リンク し て 	 りんく し て
デビュー し 	 でびゅー し
合う 	 あう
設け 	 もうけ
打っ て 	 うっ て
確認 する 	 かくにん する
デザイン さ れ た 	 でざいん さ れ た
上回っ て 	 うわまわっ て
評価 さ れ 	 ひょうか さ れ
出席 し た 	 しゅっせき し た
病み 	 やみ
つき 	 つき
引い て 	 ひい て
施す 	 ほどこす
分類 さ れ て 	 ぶんるい さ れ て
支持 し た 	 しじ し た
膨らん 	 ふくらん
加わる 	 くわわる
整備 さ れ て 	 せいび さ れ て
集める 	 あつめる
育ち 	 そだち
剥がさ れ 	 はがさ れ
使わ れ 	 つかわ れ
溶かさ れ て 	 とかさ れ て
変え られ 	 かえ られ
掬う 	 すくう
使わ れ た 	 つかわ れ た
任せし まし た 	 まかせし まし た
考え ない 	 かんがえ ない
発揮 する 	 はっき する
選べ 	 えらべ
興奮 する 	 こうふん する
思っ ちゃう 	 おもっ ちゃう
訪れ て 	 おとずれ て
再現 し た 	 さいげん し た
言及 し て 	 げんきゅう し て
介入 す べし 	 かいにゅう す べし
思わ ない 	 おもわ ない
使い分ける 	 つかいわける
比較 する 	 ひかく する
より 	 より
シフト し て 	 しふと し て
待つ 	 まつ
受け られる 	 うけ られる
取り まし た 	 とり まし た
給油 でき ない 	 きゅうゆ でき ない
増え 	 ふえ
陥り まし た 	 おちいり まし た
構わ ず 	 かまわ ず
のろけ 	 のろけ
さ せ ませ ん 	 さ せ ませ ん
提案 し 	 ていあん し
賛同 	 さんどう
退役 し 	 たいえき し
保管 さ れる 	 ほかん さ れる
求め られ た 	 もとめ られ た
就任 さ せ 	 しゅうにん さ せ
提案 し た 	 ていあん し た
回航 さ れ 	 かいこう さ れ
到着 し た 	 とうちゃく し た
割い て 	 わりい て
検討 し ましょ う 	 けんとう し ましょ う
至っ た そうです 	 いたっ た そうです
支持 し て 	 しじ し て
関係 する 	 かんけい する
同期 さ せる 	 どうき さ せる
取り扱っ て 	 とりあつかっ て
配置 し 	 はいち し
開放 し た 	 かいほう し た
チャレンジ さ れる 	 ちゃれんじ さ れる
いらっしゃり 	 いらっしゃり
真似 て 	 まね て
増やそ う 	 ふやそ う
考え た 	 かんがえ た
参加 する 	 さんか する
利用 さ せ て 	 りよう さ せ て
得れ 	 えれ
求め まし た 	 もとめ まし た
掲載 する 	 けいさい する
決まっ て 	 きまっ て
断ら れ まし た 	 ことわら れ まし た
区分 さ れる 	 くぶん さ れる
立ち上げ た 	 たちあげ た
受ける ように なっ た 	 うける ように なっ た
築い た 	 きずい た
連れ て 	 つれ て
思える 	 おもえる
とっ て 	 とっ て
奪回 し 	 だっかい し
仕掛け て 	 しかけ て
混乱 さ せ 	 こんらん さ せ
包囲 する 	 ほうい する
認定 さ れ まし た 	 にんてい さ れ まし た
標榜 し て 	 ひょうぼう し て
取 らさ れる 	 と らさ れる
連絡 する 	 れんらく する
話し やすい 	 はなし やすい
持ち去ら れ た 	 もちさら れ た
み られ 	 み られ
返却 さ れ た 	 へんきゃく さ れ た
西進 し た 	 せいしん し た
明かす 	 あかす
見 かける 	 み かける
襲撃 し て 	 しゅうげき し て
奪っ 	 うばっ
殺し て 	 ころし て
数え られ て 	 かぞえ られ て
侵入 し て 	 しんにゅう し て
転 し て 	 ころ し て
向かっ た 	 むかっ た
驚く 	 おどろく
なる かもしれ ない 	 なる かもしれ ない
追い込む 	 おいこむ
連敗 し て 	 れんぱい し て
喫する 	 きっする
突入 	 とつにゅう
波及 し て 	 はきゅう し て
衰える 	 おとろえる
いい ます 	 いい ます
もたらし た 	 もたらし た
反映 さ れ た 	 はんえい さ れ た
隠れ た 	 かくれ た
癒やし 	 いやし
エスカレート さ せ た 	 えすかれーと さ せ た
補強 し た 	 ほきょう し た
立ち上げ 	 たちあげ
被弾 し た 	 ひだん し た
張ら せ て 	 はら せ て
作 れる 	 つく れる
誤認 さ れる 	 ごにん さ れる
避ける 	 さける
改称 し た 	 かいしょう し た
連呼 し まし た 	 れんこ し まし た
かけ 過ぎ て 	 かけ すぎ て
思いあたる 	 おもいあたる
運ぶ 	 はこぶ
オススメ し ます 	 おすすめ し ます
承認 する 	 しょうにん する
取る 	 とる
あて られ た 	 あて られ た
舞う 	 まう
思 える ように なっ て 	 おも える ように なっ て
流出 する 	 りゅうしゅつ する
指摘 さ れ て 	 してき さ れ て
見 た 	 み た
志願 し 	 しがん し
独占 さ れ て 	 どくせん さ れ て
なり たいです 	 なり たいです
改善 し たい 	 かいぜん し たい
押す 	 おす
訪ね 	 たずね
墜落 し 	 おお し
観測 さ れ た 	 かんそく さ れ た
得 られ て 	 え られ て
ボーっと し て 	 ぼーっと し て
開催 さ れ 	 かいさい さ れ
数え 	 かぞえ
輩出 し て 	 はいしゅつ し て
推移 し た 	 すいい し た
近づく 	 ちかづく
強まっ た 	 つよまっ た
相次い だ 	 あいつい だ
達成 し た 	 たっせい し た
貫き 	 つらぬき
取り巻く 	 とりまく
振り回す 	 ふりまわす
従う 	 したがう
受け まし た 	 うけ まし た
仕事 し て 	 しごと し て
直し て 	 なおし て
揺れ た 	 ゆれ た
探り ます 	 さぐり ます
運転 し 始め て 	 うんてん し はじめ て
終了 する 	 しゅうりょう する
期待 さ れる 	 きたい さ れる
陥れる 	 おとしいれる
進学 する 	 しんがく する
追加 さ れる 	 ついか さ れる
つき 合っ て 	 つき あっ て
いる ようだ 	 いる ようだ
登場 し ない 	 とうじょう し ない
やめる べき 	 やめる べき
譲る 	 ゆずる
挿入 さ れ て 	 そうにゅう さ れ て
手に入れ て 	 てにいれ て
固め た 	 かため た
えい航 し 	 えいこう し
着け た 	 つけ た
変身 し て 	 へんしん し て
経過 	 けいか
盛り付け 	 もりつけ
行け て 	 いけ て
居座っ て 	 いすわっ て
賄う 	 まかなう
発明 さ れ た 	 はつめい さ れ た
打つ 	 うつ
腹立つ 	 はらだつ
整理 し 	 せいり し
見 直し 	 み なおし
中断 し た 	 ちゅうだん し た
破っ た 	 やぶっ た
測定 し て 	 そくてい し て
下がっ た 	 さがっ た
言える 	 いえる
先読み し 	 さきよみ し
尽くし て 	 つくし て
フォロー する 	 ふぉろー する
没収 さ れ て 	 ぼっしゅう さ れ て
終焉 し 	 しゅうえん し
通っ た 	 かよっ た
占領 し た 	 せんりょう し た
減らし て 	 へらし て
応答 する 	 おうとう する
判ら ない 	 わから ない
事故死 し て 	 じこし し て
問わ れる 	 とわ れる
拡充 する 	 かくじゅう する
拡大 する 	 かくだい する
分裂 する 	 ぶんれつ する
閉じ込める 	 とじこめる
乗り出し 	 のりだし
立ち上げる 	 たちあげる
確認 し まし た 	 かくにん し まし た
定義 さ れ た 	 ていぎ さ れ た
及ぼす 	 およぼす
規定 さ れ て 	 きてい さ れ て
属し て 	 ぞくし て
生じ 	 しょうじ
基づく 	 もとづく
誕生 し た 	 たんじょう し た
禁止 さ れ た 	 きんし さ れ た
係争 	 けいそう
飼っ て 	 かっ て
犯さ れ た 	 おかさ れ た
診断 し て 	 しんだん し て
聞き出し た 	 ききだし た
購読 さ れる 	 こうどく さ れる
壊滅 し た 	 かいめつ し た
取得 	 しゅとく
配属 さ れ た 	 はいぞく さ れ た
検出 さ れ なかっ た 	 けんしゅつ さ れ なかっ た
届い て 	 とどい て
黙っ て 	 だまっ て
拝借 し て 	 はいしゃく し て
付け て 	 つけ て
おこなわ れ て 	 おこなわ れ て
分け 合う 	 わけ あう
改良 し た 	 かいりょう し た
いただき まし た 	 いただき まし た
生え て 	 はえ て
歩き回ら ない 	 あるきまわら ない
所有 し て 	 しょゆう し て
加わっ た 	 くわわっ た
やめ 	 やめ
変更 し て 	 へんこう し て
異なっ て 	 ことなっ て
引退 し 	 いんたい し
抜ける 	 ぬける
危ぶま れる 	 あやぶま れる
脅かそ う 	 おびやか そう
おい て 	 おい て
従え て 	 したがえ て
動揺 し 	 どうよう し
抱い て 	 いだい て
破壊 さ れ た 	 はかい さ れ た
消滅 し 	 しょうめつ し
離脱 する 	 りだつ する
位置 し 	 いち し
検索 できる 	 けんさく できる
欠損 し て 	 けっそん し て
開設 する 	 かいせつ する
乾燥 する 	 かんそう する
混入 し た 	 こんにゅう し た
見え ます 	 みえ ます
設置 さ れ た 	 せっち さ れ た
従事 し 	 じゅうじ し
伝え たく 	 つたえ たく
電話 し まし た 	 でんわ し まし た
連絡 いたし ませ ん 	 れんらく いたし ませ ん
精査 する 	 せいさ する
ヒット する 	 ひっと する
解消 し 	 かいしょう し
オススメ できる 	 おすすめ できる
並べ 	 ならべ
異なっ 	 ことなっ
尋ね た 	 たずね た
承り ます 	 うけたまわり ます
信仰 し て 	 しんこう し て
持ち でしょ う 	 もち でしょ う
放置 し た 	 ほうち し た
釈明 	 しゃくめい
存続 し た 	 そんぞく し た
送り込む 	 おくりこむ
偵察 し た 	 ていさつ し た
集まり 	 あつまり
変化 さ せ よう 	 へんか さ せ よう
頼ま れ 	 たのま れ
依れ 	 えれ
具足 する 	 ぐそく する
したがっ て 	 したがっ て
たい て 	 たい て
ひかえ て 	 ひかえ て
送ら せ て 	 おくら せ て
挙げ られ て 	 あげ られ て
暴れ 回る 	 あば れまわる
働か ない 	 はたらか ない
働く 	 はたらく
維持 し て 	 いじ し て
埋まっ て 	 うまっ て
停止 さ れ 	 ていし さ れ
占拠 さ れ て 	 せんきょ さ れ て
復帰 し て 	 ふっき し て
選出 さ れ た 	 せんしゅつ さ れ た
駆け寄っ て 	 かけよっ て
くらまし た 	 くらまし た
たっ た 	 たっ た
広め た 	 ひろめ た
違い 	 ちがい
採点 さ れ 	 さいてん さ れ
すぎる 	 すぎる
食べ たく て 	 たべ たく て
い れる 	 い れる
いれ て 	 いれ て
始め られ 	 はじめ られ
掲載 	 けいさい
貢献 し 	 こうけん し
影響 する 	 えいきょう する
入ってい ます 	 はいってい ます
眠 れ ない 	 ねむ れ ない
あり ませ ん でした 	 あり ませ ん でした
訴え かける 	 うったえ かける
援用 し た 	 えんよう し た
似 合う 	 に あう
受賞 し た 	 じゅしょう し た
確立 し て 	 かくりつ し て
悪用 する 	 あくよう する
出し た 	 だし た
避け まし た 	 さけ まし た
受け継が れ て 	 うけつが れ て
一致 し て 	 いっち し て
葬る ように 	 ほうむる ように
持ち歩く 	 もちあるく
なくなり ます 	 なくなり ます
登場 し 	 とうじょう し
戻す 	 もどす
見据え た 	 みすえ た
団結 し 	 だんけつ し
結成 し 	 けっせい し
おちぶれ 	 おちぶれ
煽っ た 	 あおっ た
逃げ られる 	 にげ られる
活躍 し て 	 かつやく し て
入り する 	 いり する
付き合う ように なる 	 つきあう ように なる
糾弾 する 	 きゅうだん する
掲載 し 	 けいさい し
送付 し た 	 そうふ し た
優勝 し て 	 ゆうしょう し て
抱く ような 	 だく ような
なり 得る 	 なり うる
巡る 	 めぐる
確かめ 	 たしかめ
巡っ て 	 めぐっ て
み 	 み
いたし て 	 いたし て
頑張っ て 	 がんばっ て
取り戻そ う 	 とりもど そう
勉強 し 	 べんきょう し
働き まし た 	 はたらき まし た
通過 する 	 つうか する
対決 	 たいけつ
とる よう 	 とる よう
命じ た 	 めいじ た
製作 し た 	 せいさく し た
服用 し た 	 ふくよう し た
協議 する よう 	 きょうぎ する よう
求め た 	 もとめ た
恵まれ た 	 めぐまれ た
なろ う 	 なろ う
超え 	 こえ
伸び た 	 のび た
イメージ でき て 	 いめーじ でき て
成り立っ て 	 なりたっ て
受け うる 	 うけ うる
逃れる 	 のがれる
説得 できる 	 せっとく できる
あまり 	 あまり
びっくり し て 	 びっくり し て
録画 さ れ た 	 ろくが さ れ た
語り ます 	 かたり ます
行う べき 	 おこなう べき
知らさ れ た 	 しらさ れ た
志願 し て 	 しがん し て
辞退 する 	 じたい する
認め られ て 	 みとめ られ て
あやかっ て 	 あやかっ て
治まり 	 おさまり
移行 する 	 いこう する
栽培 し た 	 さいばい し た
所在 する 	 しょざい する
撃ち 	 うち
命中 さ せ て 	 めいちゅう さ せ て
死亡 さ せ た 	 しぼう さ せ た
合成 さ れる 	 ごうせい さ れる
めざめ 	 めざめ
キャスティング さ れ た 	 きゃすてぃんぐ さ れ た
発見 さ れ た 	 はっけん さ れ た
販売 さ れ て 	 はんばい さ れ て
語ら れ て 	 かたら れ て
落ち着い た 	 おちつい た
つ け 込ま れ て 	 つ け こま れ て
なら ず 	 なら ず
手掛け た 	 てがけ た
寄せ て 	 よせ て
飛び降り た 	 とびおり た
倒れ 	 たおれ
断念 	 だんねん
葬ら れ た 	 ほうむら れ た
上る 	 のぼる
座っ て 	 すわっ て
つまづい た 	 つまづい た
激励 し て 	 げきれい し て
遊び 	 あそび
よっ て 	 よっ て
カムバック し 	 かむばっく し
リラックス でき た 	 りらっくす でき た
見 られ なく て 	 み られ なく て
報じ られ た 	 ほうじ られ た
死に たい 	 しに たい
訴え た 	 うったえ た
拘ら ず 	 こだわら ず
助け 	 たすけ
来 て 	 き て
磨く 	 みがく
聴く 	 きく
調べる 	 しらべる
使わ ない 	 つかわ ない
符号化 する 	 ふごうか する
焼く 	 やく
パリパリ 	 ぱりぱり
混同 さ れる 	 こんどう さ れる
関連 し た 	 かんれん し た
致し ます 	 いたし ます
ボッタくら れる 	 ぼったくら れる
ドキドキ し 	 どきどき し
困り な 	 こまり な
検討 	 けんとう
出来 ます 	 でき ます
閉まっ た 	 しまっ た
頼み 	 たのみ
確定 し 	 かくてい し
アップ する 	 あっぷ する
慣れる 	 なれる
就 ける 	 つ ける
攻撃 できる 	 こうげき できる
談笑 する 	 だんしょう する
リンク さ れ て 	 りんく さ れ て
誤解 さ れ がちで ある 	 ごかい さ れ がちで ある
なさ れ た 	 なさ れ た
除け 	 よけ
発行 し て 	 はっこう し て
立て て 	 たて て
プレゼンテーション し て 	 ぷれぜんてーしょん し て
通っ たら 	 かよっ たら
通ら なかっ た 	 とおら なかっ た
宿り 	 やどり
浮かび上がる 	 うかびあがる
なる べく 	 なる べく
見え ない ように し て 	 みえ ない ように し て
悲しみ 	 かなしみ
贈っ た 	 おくっ た
換算 さ れ た 	 かんさん さ れ た
補償 さ れる 	 ほしょう さ れる
掲げ 	 かかげ
整備 さ れ た 	 せいび さ れ た
アピール し た 	 あぴーる し た
さ せ て 	 さ せ て
取れ て 	 とれ て
付い て 	 つい て
気づき 	 きづき
思い出し 	 おもいだし
進出 し て 	 しんしゅつ し て
タッピング し なければ なら ない 	 たっぴんぐ し なければ なら ない
編成 さ れ た 	 へんせい さ れ た
流れ 出し 	 なが れだし
出力 さ れ た 	 しゅつりょく さ れ た
逸らす 	 そらす
インストール する 	 いんすとーる する
表示 する 	 ひょうじ する
リセット さ れ ませ ん 	 りせっと さ れ ませ ん
反対 し 続け て 	 はんたい し つづけ て
誇っ て 	 ほこっ て
融合 さ せ た 	 ゆうごう さ せ た
構築 し 	 こうちく し
推奨 する 	 すいしょう する
及ん 	 およん
確認 さ れる 	 かくにん さ れる
取りやめる 	 とりやめる
観戦 	 かんせん
直行 	 ちょっこう
投げる 	 なげる
驚嘆 し た 	 きょうたん し た
移さ れ た 	 うつさ れ た
関連 し そうな 	 かんれん し そうな
やり たく て 	 やり たく て
やっ た 	 やっ た
混入 し て 	 こんにゅう し て
休養 さ せる 	 きゅうよう さ せる
降格 し た 	 こうかく し た
放っ た 	 はなっ た
買い 	 かい
切ら れ た 	 きら れ た
演奏 さ れ て 	 えんそう さ れ て
派遣 さ れる 	 はけん さ れる
通じ た 	 つうじ た
努める 	 つとめる
入り し た 	 いり し た
盗み見 さ れ た 	 ぬすみみ さ れ た
気付き 	 きづき
派遣 し た 	 はけん し た
活かさ れ て 	 いかさ れ て
めざし 	 めざし
愛し 	 いとし
尊び 	 そんび
重んじ 	 おもんじ
充ち た 	 みち た
尽くす 	 つくす
遮断 さ れ た 	 しゃだん さ れ た
操り 	 あやつり
し なけれ 	 し なけれ
発揮 でき ず 	 はっき でき ず
見抜か れ て 	 みぬか れ て
渡り 	 わたり
降伏 	 こうふく
争い 	 あらそい
敗れ 	 やぶれ
追い出さ れ た 	 おいださ れ た
呼称 さ れ て 	 こしょう さ れ て
侵し て 	 おかし て
注目 さ れ ます 	 ちゅうもく さ れ ます
引き継が れ て 	 ひきつが れ て
築き上げ て 	 きずきあげ て
投下 し た 	 とうか し た
理解 し よう 	 りかい し よう
関し て 	 かんし て
秘匿 する 	 ひとく する
貫い て 	 つらぬい て
知ら ず 	 しら ず
明かさ れ た 	 あかさ れ た
広がる 	 ひろがる
招聘 さ れ 	 しょうへい さ れ
退官 	 たいかん
置け 	 おけ
知らせ ない 	 しらせ ない
入ろ う 	 はいろ う
選ん だ 	 せんん だ
加算 し て 	 かさん し て
注文 する 	 ちゅうもん する
掛け 	 かけ
競り落とさ れ た 	 せりおとさ れ た
運ば れる 	 はこば れる
やせ て 	 やせ て
泊まる 	 とまる
生産 さ れ 	 せいさん さ れ
渡る 	 わたる
支配 	 しはい
付け た 	 つけ た
重視 する 	 じゅうし する
いえ そうだ 	 いえ そうだ
通院 し まし た 	 つういん し まし た
完治 し まし た 	 かんち し まし た
繁殖 し た 	 はんしょく し た
死亡 し 	 しぼう し
決定 し 	 けってい し
配置 し て 	 はいち し て
ちぎり 	 ちぎり
加工 し て 	 かこう し て
定着 さ せ た 	 ていちゃく さ せ た
退社 	 たいしゃ
腫れる 	 はれる
いう ように 	 いう ように
延び て 	 のび て
使用 し ない 	 しよう し ない
運行 し て 	 うんこう し て
収束 さ せ 	 しゅうそく さ せ
蒸散 さ せる 	 じょうさん さ せる
服属 し て 	 ふくぞく し て
立ち並び 	 たちならび
販売 し て 	 はんばい し て
死去 し 	 しきょ し
号さ れ た 	 ごうさ れ た
走行 する 	 そうこう する
参加 し 	 さんか し
優勝 	 ゆうしょう
進展 し て 	 しんてん し て
完成 し て 	 かんせい し て
罹り 	 かかり
来場 し た 	 らいじょう し た
痩せ すぎ 	 やせ すぎ
対極 する 	 たいきょく する
もぎ 	 もぎ
たて 	 たて
運行 さ れ 	 うんこう さ れ
遺し た 	 のこし た
頼み ます 	 たのみ ます
誇り 	 ほこり
用い られ た 	 もちい られ た
勧誘 し て 	 かんゆう し て
明かさ れ 	 あかさ れ
暴走 し た 	 ぼうそう し た
倒し 	 たおし
受け取る 	 うけとる
やる 	 やる
出版 さ れる 	 しゅっぱん さ れる
混在 さ せ て 	 こんざい さ せ て
薦めし たく 	 すすめし たく
面し た 	 めんし た
対し て 	 たいし て
連なっ て 	 つらなっ て
出現 	 しゅつげん
醸成 さ れ て 	 じょうせい さ れ て
遂げ 	 とげ
合成 出来 ない 	 ごうせい でき ない
見いだす 	 みいだす
至っ た 	 いたっ た
陳謝 	 ちんしゃ
料理 	 りょうり
記さ れ て 	 きさ れ て
掛け て 	 かけ て
捨て たく なかっ た 	 すて たく なかっ た
潜入 する 	 せんにゅう する
着用 する 	 ちゃくよう する
就任 し て 	 しゅうにん し て
追求 し て 	 ついきゅう し て
立てる 	 たてる
涙ぐん 	 なみだぐん
悼み 	 いたみ
付き添っ た 	 つきそっ た
なぐさめ て 	 なぐさめ て
運行 さ れ て 	 うんこう さ れ て
入れ られ た 	 いれ られ た
かけ られ て 	 かけ られ て
分かり まし た 	 わかり まし た
逮捕 する 	 たいほ する
合し て 	 あし て
造る 	 つくる
失脚 し 	 しっきゃく し
宣言 さ れ た 	 せんげん さ れ た
怒っ た 	 おこっ た
気づい た 	 きづい た
決意 する 	 けつい する
吸わ ない 	 すわ ない
オススメ でき ない 	 おすすめ でき ない
大活躍 する 	 だいかつやく する
両立 さ せる 	 りょうりつ さ せる
伝送 し て 	 でんそう し て
いえる でしょ う 	 いえる でしょ う
立証 する 	 りっしょう する
申請 	 しんせい
投降 し て 	 とうこう し て
覆っ て 	 おおっ て
辞任 し まし た 	 じにん し まし た
つくら れ た 	 つくら れ た
言う なら 	 いう なら
容認 する 	 ようにん する
誘う 	 さそう
組み合わせ た 	 くみあわせ た
出品 	 しゅっぴん
納得 でき まい 	 なっとく でき まい
漁る 	 りょうる
悪化 する 	 あっか する
退任 し 	 たいにん し
就任 する 	 しゅうにん する
スポーツ 	 すぽーつ
払っ て 	 はらっ て
伺 え ます 	 うかが え ます
提供 できる 	 ていきょう できる
利用 できる 	 りよう できる
取り次い 	 とりつぐい
越す 	 こす
雇わ れ 	 やとわ れ
視認 する 	 しにん する
満足 出来 なけれ 	 まんぞく でき なけれ
製作 する 	 せいさく する
もっ た 	 もっ た
分離 する 	 ぶんり する
結成 し た 	 けっせい し た
通う 	 かよう
見誤っ た 	 みあやまっ た
追いやる 	 おいやる
払う 	 はらう
もつ 	 もつ
落ち込ん 	 おちこん
い られ ない 	 い られ ない
リーク さ れ た 	 りーく さ れ た
明かし て 	 あかし て
変る 	 へんる
枯れ ない 	 かれ ない
引っ越す 	 ひっこす
経験 し て 	 けいけん し て
体験 し た 	 たいけん し た
あり すぎ て 	 あり すぎ て
吹き にくい 	 ふき にくい
対応 し たい 	 たいおう し たい
下賜 さ れ た 	 かし さ れ た
負っ た 	 おっ た
復調 し 	 ふくちょう し
移転 し 	 いてん し
編成 さ れる 	 へんせい さ れる
運用 できる 	 うんよう できる
開発 さ れ て 	 かいはつ さ れ て
則っ て 	 のっとっ て
紹介 さ れ た 	 しょうかい さ れ た
抗議 し た 	 こうぎ し た
関わっ て 	 かかわっ て
負け ず 	 まけ ず
立候補 し た 	 りっこうほ し た
映っ て 	 うつっ て
上り 	 のぼり
プレイ し て 	 ぷれい し て
いため 	 いため
付け られ た 	 つけ られ た
なる ように 	 なる ように
反転 さ せる 	 はんてん さ せる
就任 	 しゅうにん
耐震 	 たいしん
化 さ せる 	 か さ せる
移そ う 	 うつ そう
放送 し た 	 ほうそう し た
タッチ 	 たっち
指名 	 しめい
とどまっ た 	 とどまっ た
見つけ まし た 	 みつけ まし た
計測 さ れ た 	 けいそく さ れ た
通過 し て 	 つうか し て
過ごす ような 	 すごす ような
絡む 	 からむ
判断 する 	 はんだん する
言え よう 	 いえ よう
貸切っ て 	 かしきりっ て
上昇 する 	 じょうしょう する
出さ れ 	 ださ れ
巻き込ま れ た 	 まきこま れ た
悩み 	 なやみ
痛ん 	 いたん
起用 さ れ 	 きよう さ れ
記録 	 きろく
勤務 し はじめ て 	 きんむ し はじめ て
履い た 	 はい た
採ら なく なっ た 	 とら なく なっ た
膨れ上がっ た 	 ふくれあがっ た
展開 さ れ た 	 てんかい さ れ た
触れ た 	 ふれ た
確認 でき ず 	 かくにん でき ず
弁じ 	 べんじ
報じ られ 	 ほうじ られ
指摘 し た 	 してき し た
催さ れ 	 もよおさ れ
出 回ら ない ような 	 で まわら ない ような
出 回る 	 で まわる
現れ て 	 あらわれ て
可決 	 かけつ
滅亡 し ませ ん 	 めつぼう し ませ ん
集め られ て 	 あつめ られ て
振ら ない ように 	 ふら ない ように
公表 さ れ た 	 こうひょう さ れ た
し た よう です 	 し た よう です
援護 し た 	 えんご し た
使い ませ ん 	 つかい ませ ん
周知 さ せ 	 しゅうち さ せ
守ら せる よう 	 まもら せる よう
徹底 し なければ なら ない 	 てってい し なければ なら ない
逃げ て 	 にげ て
前進 し て 	 ぜんしん し て
拒ん だ 	 こばん だ
殴っ た 	 なぐっ た
付きまとっ て 	 つきまとっ て
加盟 し 	 かめい し
否定 さ れる 	 ひてい さ れる
すく 	 すく
落と せ ず 	 おと せ ず
駐屯 し た 	 ちゅうとん し た
行 える 	 おこな える
寄生 する 	 きせい する
起こす 	 おこす
ノミネート さ れ 	 のみねーと さ れ
眠り 	 ねむり
義務付け て 	 ぎむづけ て
移住 さ せ られ 	 いじゅう さ せ られ
従事 する 	 じゅうじ する
広まる 	 ひろまる
囁か れ 始める 	 ささやか れ はじめる
観察 さ れ た 	 かんさつ さ れ た
休ま せ 	 やすま せ
退避 	 たいひ
収録 さ れ た 	 しゅうろく さ れ た
初登場 する 	 はつとうじょう する
味わっ て 	 あじわっ て
協議 し 	 きょうぎ し
確認 	 かくにん
制定 さ れ 	 せいてい さ れ
設け られ た 	 もうけ られ た
独占 し て 	 どくせん し て
振り返り 	 ふりかえり
比較 し た 	 ひかく し た
航行 し 	 こうこう し
読み上げ られる 	 よみあげ られる
メモ する 	 めも する
完成 さ せる 	 かんせい さ せる
浮上 し 	 ふじょう し
とれ ず 	 とれ ず
忘れ去ら れる 	 わすれさら れる
登場 し た 	 とうじょう し た
触発 さ れ 	 しょくはつ さ れ
縫い合わせ た 	 ぬいあわせ た
持参 し た 	 じさん し た
感謝 し て 	 かんしゃ し て
換金 する 	 かんきん する
際立っ て 	 きわだっ て
きい て 	 きい て
廃止 し 	 はいし し
追求 し た 	 ついきゅう し た
付き合っ て 	 つきあっ て
仕入れ た 	 しいれ た
小分け し て 	 こわけ し て
悪びれ た 	 わるびれ た
緊張 さ れる かもしれ ませ ん 	 きんちょう さ れる かもしれ ませ ん
所属 し 	 しょぞく し
活躍 	 かつやく
強め た 	 つよめ た
できる ように なり ます 	 できる ように なり ます
言わ ず 	 いわ ず
知れ た 	 しれ た
依存 する 	 いぞん する
惑わす 	 まどわす
かき回す 	 かきまわす
疑っ た 	 うたがっ た
支給 し た 	 しきゅう し た
燃え盛る 	 もえさかる
聞き たい 	 きき たい
大破 	 たいは
生産 する 	 せいさん する
値する ような 	 ちする ような
作ら れ て 	 つくら れ て
加入 し なければ なら ない 	 かにゅう し なければ なら ない
明け て 	 あけ て
みなさ ん 	 みなさ ん
済ませ た ようで 	 すませ た ようで
飾ら れ て 	 かざら れ て
呼ば ず 	 よば ず
総称 し た 	 そうしょう し た
乱さ ず 	 らんさ ず
なじ める 	 なじ める
収集 し た 	 しゅうしゅう し た
飲み 始め て 	 のみ はじめ て
感じ られ て 	 かんじ られ て
応募 し 	 おうぼ し
決定 し まし た 	 けってい し まし た
余し て 	 あまし て
運ば れ て 	 はこば れ て
びっくり し まし た 	 びっくり し まし た
追い詰め られ 	 おいつめ られ
負う 	 おう
救わ れる 	 すくわ れる
吸い上げ た 	 すいあげ た
至ら ず 	 いたら ず
見 ない 	 み ない
余っ て 	 あまっ て
書い た ように 	 かい た ように
接触 し て 	 せっしょく し て
試み 	 こころみ
同意 し た 	 どうい し た
要望 する 	 ようぼう する
放送 し て 	 ほうそう し て
融合 する 	 ゆうごう する
な れる 	 な れる
用意 でき ない 	 ようい でき ない
組ま れ 	 くま れ
販売 し 	 はんばい し
貢献 する 	 こうけん する
求め られ て 	 もとめ られ て
かい て 	 かい て
遊ん 	 あそん
怒る 	 おこる
表示 し 	 ひょうじ し
踏ま せ ない 	 ふま せ ない
守り きり 	 まもり きり
完封 	 かんぷう
避け よう 	 さけ よう
とらえる 	 とらえる
要求 し た 	 ようきゅう し た
認め ず 	 みとめ ず
緊張 し なく て 	 きんちょう し なく て
助かっ た 	 たすかっ た
謝罪 する 	 しゃざい する
吸引 し た 	 きゅういん し た
模索 し て 	 もさく し て
見 出し て 	 み いだし て
製作 し 	 せいさく し
担当 し た 	 たんとう し た
褒め 	 ほめ
返し 	 がえし
沸か せ た 	 わか せ た
根付い て 	 ねづい て
引き抜く 	 ひきぬく
適合 する 	 てきごう する
やめ て 	 やめ て
発達 し て 	 はったつ し て
諦め て 	 あきらめ て
通わ なく なり まし た 	 かよわ なく なり まし た
楽になっ て 	 らくになっ て
採択 さ れ た 	 さいたく さ れ た
盛り込ま れ た 	 もりこま れ た
義務付け られる 	 ぎむづけ られる
プロデュース する 	 ぷろでゅーす する
わたし 	 わたし
ブレイク し 	 ぶれいく し
先制 し て 	 せんせい し て
保っ た 	 たもっ た
進出 	 しんしゅつ
願い できる 	 ねがい できる
従え た 	 したがえ た
問い 	 とい
ただす 	 ただす
変え ない 	 かえ ない
なら ない 	 なら ない
噴出 	 ふんしゅつ
任じ られ 	 にんじ られ
封じ られ た 	 ふうじ られ た
はじき 	 はじき
返し た 	 かえし た
頒布 する 	 はんぷ する
のぼり ます 	 のぼり ます
沿っ た 	 そっ た
維持 でき なく なり 	 いじ でき なく なり
圧倒 し た 	 あっとう し た
奏功 し て 	 そうこう し て
限ら ず 	 かぎら ず
密集 し て 	 みっしゅう し て
生息 し て 	 せいそく し て
共存 する 	 きょうぞん する
写っ て 	 うつっ て
放送 する 	 ほうそう する
利用 さ れる 	 りよう さ れる
切り上げ て 	 きりあげ て
留守番 し て 	 るすばん し て
同居 する ように なる 	 どうきょ する ように なる
編集 さ れ た 	 へんしゅう さ れ た
疲れ 	 つかれ
体現 し て 	 たいげん し て
持ち上げる 	 もちあげる
廃止 し て 	 はいし し て
議決 する 	 ぎけつ する
知ら れ た 	 しら れ た
用い 	 もちい
脚色 し た 	 きゃくしょく し た
掲げ た 	 かかげ た
残し 	 のこし
攻撃 	 こうげき
見渡す 	 みわたす
満足 できる 	 まんぞく できる
落ち着き まし た 	 おちつき まし た
見いだし 	 みいだし
信頼 し た 	 しんらい し た
注意 し たく なる 	 ちゅうい し たく なる
続落 し 	 ぞくらく し
反落 し た 	 はんらく し た
指摘 する 	 してき する
嘲笑 する 	 ちょうしょう する
描き 	 えがき
進化 し た 	 しんか し た
作ら れ た 	 つくら れ た
かかり ませ ん 	 かかり ませ ん
一致 し た 	 いっち し た
選び 	 えらび
紹介 し ます 	 しょうかい し ます
会っ た 	 あっ た
修める 	 おさめる
倒そ う 	 たお そう
向かっ て 	 むかっ て
上回っ た 	 うわまわっ た
満た ない 	 みた ない
捻出 する 	 ねんしゅつ する
温め 続け 	 あたため つづけ
取り上げ られる 	 とりあげ られる
つけ られ た 	 つけ られ た
羽織り 	 はねおり
発揮 し た 	 はっき し た
教わっ た 	 おそわっ た
確認 できる 	 かくにん できる
探す 	 さがす
話せる 	 はなせる
報せ た 	 しらせ た
行う よう 	 おこなう よう
記念 し て 	 きねん し て
建立 さ れ た 	 こんりゅう さ れ た
頼る 	 たよる
確認 さ れ 	 かくにん さ れ
ストップ 	 すとっぷ
取り やすく 	 とり やすく
提供 し て 	 ていきょう し て
食べ させる ように 	 たべ させる ように
そそのかし た 	 そそのかし た
形成 し 	 けいせい し
形成 さ れる 	 けいせい さ れる
学ん だ 	 まなん だ
遅れ て 	 おくれ て
あて なかっ た 	 あて なかっ た
オススメ する 	 おすすめ する
おもっ て 	 おもっ て
なる よう です 	 なる よう です
削除 さ れ て 	 さくじょ さ れ て
返上 し た 	 へんじょう し た
普及 さ せ た 	 ふきゅう さ せ た
作ら れ 	 つくら れ
普及 さ れ た 	 ふきゅう さ れ た
開業 し た 	 かいぎょう し た
展開 し よう 	 てんかい し よう
応援 し て 	 おうえん し て
赴い て 	 おもむい て
学ん 	 まなん
争う 	 あらそう
崩壊 	 ほうかい
出店 し て 	 しゅってん し て
欠落 し た 	 けつらく し た
凍結 さ れる 	 とうけつ さ れる
すまし て 	 すまし て
上陸 さ せる 	 じょうりく さ せる
発見 さ れる 	 はっけん さ れる
出来 た 	 でき た
保護 し ます 	 ほご し ます
生かす べく 	 いかす べく
保存 さ れる 	 ほぞん さ れる
告げ 	 つげ
懺悔 する 	 ざんげ する
告知 し 	 こくち し
装い 	 よそおい
授かっ た 	 さずかっ た
流す 	 ながす
いただき ます よう 	 いただき ます よう
泣か ない 	 なか ない
い たら 	 い たら
垣間見 て 	 かいまみ て
なる だろ う 	 なる だろ う
拉致 し て 	 らち し て
交代 し て 	 こうたい し て
編成 できる 	 へんせい できる
導入 さ れ て 	 どうにゅう さ れ て
挙げる なら 	 あげる なら
泊まっ た 	 とまっ た
喜ば れ ます 	 よろこば れ ます
すい て 	 すい て
切開 し た 	 せっかい し た
即死 し ない 	 そくし し ない
経験 し た 	 けいけん し た
呑む 	 のむ
おか れ て 	 おか れ て
立っ た 	 たっ た
作ら れる 	 つくら れる
投入 し 	 とうにゅう し
研究 し て 	 けんきゅう し て
担っ て 	 になっ て
回り込ん 	 まわりこん
預け ます 	 あずけ ます
始動 し 	 しどう し
支持 さ れ た 	 しじ さ れ た
評 さ れ た 	 ひょう さ れ た
勝ち進み 	 かちすすみ
譲ら ぬ 	 ゆずら ぬ
変え 	 かえ
突い て 	 つい て
操っ 	 あやつっ
集め よう 	 あつめ よう
行け ます 	 いけ ます
かぶり 	 かぶり
待た ず 	 また ず
自衛 する 	 じえい する
処刑 さ れる 	 しょけい さ れる
受け取り 	 うけとり
暮らす ように なっ た 	 くらす ように なっ た
離婚 し て 	 りこん し て
変わり ませ ん でした 	 かわり ませ ん でした
救う 	 すくう
蘇ら せる 	 よみがえら せる
発売 し た 	 はつばい し た
こめ て 	 こめ て
廻り 	 めぐり
凝り すぎ た 	 こり すぎ た
し ない よう 	 し ない よう
注意 する 	 ちゅうい する
併合 し た 	 へいごう し た
逼迫 し た 	 ひっぱく し た
存在 し た 	 そんざい し た
一喜一憂 し 	 いっき かずゆうし
置き換え られ た 	 おきかえ られ た
貫か れ た 	 つらぬか れ た
もらっ て 	 もらっ て
辞任 	 じにん
退部 し 	 たいぶ し
報告 する 	 ほうこく する
捜査 し て 	 そうさ し て
見送る 	 みおくる
操作 でき ます 	 そうさ でき ます
とりつけ 	 とりつけ
付加 し た 	 ふか し た
実現 さ せ て 	 じつげん さ せ て
拠る 	 よる
合わせ ざるを得 ない 	 あわせ ざるをえ ない
カット する 	 かっと する
高騰 し 	 こうとう し
分乗 し た 	 ぶんじょう し た
飛来 し て 	 ひらい し て
急襲 し 	 きゅうしゅう し
明け渡し た 	 あけわたし た
あり まし たら 	 あり まし たら
冷え込ん 	 ひえこん
超える かもしれ ない 	 こえる かもしれ ない
替わる よう 	 かわる よう
云う 	 いう
分から ない 	 わから ない
聞こえ て 	 きこえ て
知る 	 しる
提案 さ れ た 	 ていあん さ れ た
越える 	 こえる
記録 し 	 きろく し
取り上げ られ た 	 とりあげ られ た
モメ て 	 もめ て
アピール する 	 あぴーる する
搾取 し た 	 さくしゅ し た
移す 	 うつす
接収 さ れ て 	 せっしゅう さ れ て
引き継が れる 	 ひきつが れる
唆し 	 そそのかし
監禁 さ れ まし た 	 かんきん さ れ まし た
実施 し た 	 じっし し た
かき 	 かき
たべ たら 	 たべ たら
かき がたく 	 かき がたく
平行 し て 	 へいこう し て
偽り 	 いつわり
持ち掛け て 	 もちかけ て
詐取 し た 	 さしゅ し た
持た れ て 	 もた れ て
支える 	 ささえる
連続 し て 	 れんぞく し て
速報 	 そくほう
発車 する 	 はっしゃ する
交錯 する 	 こうさく する
リポート する 	 りぽーと する
注文 し まし た 	 ちゅうもん し まし た
停車 し て 	 ていしゃ し て
発覚 	 はっかく
直面 し がちな 	 ちょくめん し がちな
乗り越える 	 のりこえる
吻合 さ れる 	 ふんごう さ れる
生成 し 始める 	 せいせい し はじめる
出 なく なる 	 で なく なる
疲れ 切っ た 	 つかれ きっ た
通い 始め た 	 かよい はじめ た
修正 し た 	 しゅうせい し た
もつれ 込み 	 も つれこみ
吹く 	 ふく
はね返し 	 はねかえし
積み重ね た 	 つみかさね た
率い て 	 ひきい て
終え た そうだ 	 おえ た そうだ
疑問視 する 	 ぎもんし する
上がり 	 あがり
主導 し た 	 しゅどう し た
表明 	 ひょうめい
修正 し て 	 しゅうせい し て
足りる 	 たりる
喜ん だ 	 よろこん だ
得 られ ず 	 え られ ず
絶え なく なっ た 	 たえ なく なっ た
中絶 し 	 ちゅうぜつ し
離婚 	 りこん
邁進 する 	 まいしん する
抜け て 	 ぬけ て
目指し まし た 	 めざし まし た
奪わ れる 	 うばわ れる
奪回 	 だっかい
おもい ます 	 おもい ます
戦っ て 	 せんっ て
目論む 	 もくろむ
倒 せ ず 	 たお せ ず
記録 さ れ 	 きろく さ れ
留まる 	 とまる
設置 する 	 せっち する
注意 	 ちゅうい
処方 する 	 しょほう する
のん 	 のん
治ら なかっ たら 	 なおら なかっ たら
来る ように 	 くる ように
執行 さ れ た 	 しっこう さ れ た
親しみ 	 したしみ
充当 す べく 	 じゅうとう す べく
移行 し 	 いこう し
逃げ 	 にげ
誤魔化し 	 ごまかし
評価 し たい 	 ひょうか し たい
擁立 	 ようりつ
知り ませ ん 	 しり ませ ん
休業 	 きゅうぎょう
指摘 し て 	 してき し て
供給 する 	 きょうきゅう する
向っ て 	 むかっ て
とれる 	 とれる
投げ かける 	 なげ かける
被災 し た 	 ひさい し た
貼ら れ て 	 はら れ て
至ら なかっ た 	 いたら なかっ た
接客 し て 	 せっきゃく し て
見 られ たく ない 	 み られ たく ない
指定 し た 	 してい し た
使え 	 つかえ
閲覧 できる 	 えつらん できる
対応 できる 	 たいおう できる
定着 	 ていちゃく
集中 し た 	 しゅうちゅう し た
上り まし た 	 のぼり まし た
分け さ れ た 	 わけ さ れ た
建て た 	 たて た
もてなす 	 もてなす
創建 さ れ た 	 そうけん さ れ た
隣接 し て 	 りんせつ し て
し たく なかっ た 	 し たく なかっ た
解除 さ れ 	 かいじょ さ れ
辞任 し た 	 じにん し た
分析 し 	 ぶんせき し
発信 し 	 はっしん し
かく 	 かく
pr し て 	 ＰＲ し て
作成 し 	 さくせい し
制作 し 	 せいさく し
確保 できる よう 	 かくほ できる よう
含まれ た 	 ふくまれ た
外し た 	 はずし た
脅かす ように なっ た 	 おびやかす ように なっ た
仕上がり 	 しあがり
満足 出来 	 まんぞく でき
通お う 	 とおお う
所在 し て 	 しょざい し て
閉店 し た 	 へいてん し た
匿う 	 かくまう
損なっ た 	 そこなっ た
踊っ て 	 おどっ て
リフレッシュ でき た 	 りふれっしゅ でき た
密接 し て 	 みっせつ し て
設置 し て 	 せっち し て
一見 	 いっけん
産卵 する 	 さんらん する
東進 し 	 とうしん し
到達 し 	 とうたつ し
目指し た 	 めざし た
失敗 し た 	 しっぱい し た
撤退 し た 	 てったい し た
用意 さ れ た 	 ようい さ れ た
契約 し た 	 けいやく し た
恵まれ なかっ た 	 めぐまれ なかっ た
譲り受け 	 ゆずりうけ
相続 さ せ た 	 そうぞく さ せ た
購入 し たい 	 こうにゅう し たい
答え た 	 こたえ た
ひっぱっ 	 ひっぱっ
加熱 し た 	 かねつ し た
吹きつけ 	 ふきつけ
冷やす 	 ひやす
生成 する 	 せいせい する
集め た 	 あつめ た
勝ち き れ ない 	 かち き れ ない
通 える 	 かよ える
誇示 する 	 こじ する
貰 える 	 もら える
唱える 	 となえる
語 れる 	 かた れる
公開 さ れる べき 	 こうかい さ れる べき
受け持っ て 	 うけもっ て
転送 でき 	 てんそう でき
アップ し た 	 あっぷ し た
まとめ られる 	 まとめ られる
先発 し た 	 せんぱつ し た
渡さ れる 	 わたさ れる
獲得 し 	 かくとく し
結ば れる 	 むすば れる
開校 し た 	 かいこう し た
輩出 し た 	 はいしゅつ し た
連載 さ れ て 	 れんさい さ れ て
取り掛かっ た 	 とりかかっ た
避け たい 	 さけ たい
示し 	 しめし
引い た 	 ひい た
死去 	 しきょ
立地 する 	 りっち する
除い て 	 のぞい て
浮い た 	 うい た
流れ て 	 ながれ て
共通 し た 	 きょうつう し た
取り入れ られ た 	 とりいれ られ た
実施 さ れる だろ う 	 じっし さ れる だろ う
述べ 	 のべ
決定 する 	 けってい する
登録 し た 	 とうろく し た
限定 できる 	 げんてい できる
破る 	 やぶる
負け越し た 	 まけこし た
含み ます 	 ふくみ ます
優遇 さ れる 	 ゆうぐう さ れる
頼ろ う 	 たよろ う
入院 し た 	 にゅういん し た
診断 さ れ 	 しんだん さ れ
自刃 し た 	 じじん し た
叙任 する 	 じょにん する
する ように なっ た 	 する ように なっ た
書き込ま れ て 	 かきこま れ て
もたらし て 	 もたらし て
つ ける ような 	 つ ける ような
配布 さ れ た 	 はいふ さ れ た
支払う 	 しはらう
支払わ れ た 	 しはらわ れ た
返っ た 	 かえっ た
多用 さ れる 	 たよう さ れる
もらさ ず 	 もらさ ず
利用 す べき です 	 りよう す べき です
抱か れ て 	 だか れ て
立ち会い 	 たちあい
見送っ た 	 みおくっ た
追っ た 	 おっ た
侵攻 	 しんこう
開け 	 ひらけ
閉じる 	 とじる
抑える 	 おさえる
与え られ 	 あたえ られ
放送 さ れ て 	 ほうそう さ れ て
化 し 	 か し
切断 する 	 せつだん する
結合 し なければ なら ない 	 けつごう し なければ なら ない
満載 し た 	 まんさい し た
使用 さ れ 	 しよう さ れ
死亡 	 しぼう
取り上げ て 	 とりあげ て
おら れ まし た 	 おら れ まし た
活用 さ れ て 	 かつよう さ れ て
生まれ て 	 うまれ て
他界 	 たかい
改め て 	 あらため て
行列 し て 	 ぎょうれつ し て
ままなら ず 	 ままなら ず
耐え き れ ず 	 たえ き れ ず
相談 さ れ て 	 そうだん さ れ て
巡り合 え て 	 めぐりあ え て
入居 出来 たら 	 にゅうきょ でき たら
招待 し て 	 しょうたい し て
さ れ まし た 	 さ れ まし た
防い だ 	 ふせい だ
噴射 し 	 ふんしゃ し
凍結乾燥 する 	 とうけつかんそう する
定住 し 	 ていじゅう し
回し て 	 かいし て
リラックス できる 	 りらっくす できる
定まっ て 	 さだまっ て
食べ れ て 	 たべ れ て
在籍 し て 	 ざいせき し て
表明 し て 	 ひょうめい し て
活動 し 	 かつどう し
所属 	 しょぞく
語り まし た 	 かたり まし た
いき たい 	 いき たい
生き たい 	 いき たい
押収 し 	 おうしゅう し
打ち出し た 	 うちだし た
限っ て 	 かぎっ て
強化 し た 	 きょうか し た
進む ように なっ た 	 すすむ ように なっ た
存在 する よう です 	 そんざい する よう です
継承 し た 	 けいしょう し た
利用 し まし た 	 りよう し まし た
表れ た 	 あらわれ た
引き取る 	 ひきとる
思い 	 おもい
のこす 	 のこす
含ま せ た 	 ふくま せ た
仕上がる 	 しあがる
信頼 し て 	 しんらい し て
成熟 し 	 せいじゅく し
収穫 できる 	 しゅうかく できる
死ぬ 	 しぬ
来 た ような 	 き た ような
冒険 する 	 ぼうけん する
ヒット し ませ ん でした 	 ひっと し ませ ん でした
凍結 し 始め 	 とうけつ し はじめ
凍結 する 	 とうけつ する
滞っ て 	 とどこおっ て
絶え ない 	 たえ ない
食事 し て 	 しょくじ し て
き た 	 き た
分類 し まし た 	 ぶんるい し まし た
駆け抜けろ 	 かけぬけろ
開催 さ れる 	 かいさい さ れる
招待 する 	 しょうたい する
苦しん 	 くるしん
併合 し 	 へいごう し
削減 し 	 さくげん し
付さ れ て 	 つきさ れ て
知り たがっ た 	 しり たがっ た
用い られる ように なっ た 	 もちい られる ように なっ た
消耗 し て 	 しょうもう し て
呼ば れる ように 	 よば れる ように
歓迎 し て 	 かんげい し て
称讃 し 	 しょうさん し
奪還 し て 	 だっかん し て
達成 する であろ う 	 たっせい する であろ う
進言 し て 	 しんげん し て
移籍 し て 	 いせき し て
守り 続け 	 まもり つづけ
出陣 する 	 しゅつじん する
わかり やすく 	 わかり やすく
たっ て 	 たっ て
集積 し た 	 しゅうせき し た
上昇 し た 	 じょうしょう し た
縛ら れ て 	 しばら れ て
傍聴 し た 	 ぼうちょう し た
復帰 し 	 ふっき し
好走 	 こうそう
披露 さ れる 	 ひろう さ れる
脱会 し 	 だっかい し
引き連れ て 	 ひきつれ て
設立 し まし た 	 せつりつ し まし た
使い ます 	 つかい ます
挑戦 し 	 ちょうせん し
獲得 し た 	 かくとく し た
主導 し て 	 しゅどう し て
製造 し た 	 せいぞう し た
牽引 する 	 けんいん する
留まっ て 	 とまっ て
合併 し た 	 がっぺい し た
調印 	 ちょういん
引き抜か れ 	 ひきぬか れ
届け出 た 	 とどけで た
封じ込め たい 	 ふうじこめ たい
振り まし た 	 ふり まし た
活動 し て 	 かつどう し て
入植 し た 	 にゅうしょく し た
紹介 し た 	 しょうかい し た
さ せ ます 	 さ せ ます
立候補 し て 	 りっこうほ し て
圧倒 する 	 あっとう する
通行 	 つうこう
分岐 し て 	 ぶんき し て
しら ない 	 しら ない
似 た 	 に た
広まり 	 ひろまり
定着 する 	 ていちゃく する
抱か ない ように 	 いだか ない ように
増え たら 	 ふえ たら
新設 する 	 しんせつ する
製造 し 	 せいぞう し
長ける 	 たける
切れ た 	 きれ た
さ れ ない 	 さ れ ない
運用 さ れ て 	 うんよう さ れ て
いたっ て 	 いたっ て
検証 し 	 けんしょう し
解任 さ れる 	 かいにん さ れる
沸く 	 わく
分類 し て 	 ぶんるい し て
いえる 	 いえる
下がる 	 さがる
高め 	 たかめ
住む 	 すむ
成す 	 なす
待機 さ せ て 	 たいき さ せ て
クリア する 	 くりあ する
去っ た 	 さっ た
占領 し 	 せんりょう し
転がす 	 ころがす
切れ そうで 	 きれ そうで
切れ ない 	 きれ ない
チェック し 	 ちぇっく し
制限 する 	 せいげん する
断た せ 	 ことわた せ
孤立 さ せ よう 	 こりつ さ せ よう
浮気 し 難い 	 うわき し がたい
頼ま れ た 	 たのま れ た
遭遇 し て 	 そうぐう し て
停車 し ない 	 ていしゃ し ない
当選 し 	 とうせん し
切り替え て 	 きりかえ て
実行 できる 	 じっこう できる
実行 さ れ て 	 じっこう さ れ て
敢行 し た 	 かんこう し た
評価 さ れ た 	 ひょうか さ れ た
差し向け た 	 さしむけ た
成敗 さ れる 	 せいばい さ れる
加味 さ れ た ようだ 	 かみ さ れ た ようだ
もたれ て 	 もたれ て
集まり やすい です 	 あつまり やすい です
出発 	 しゅっぱつ
鈍ら せ て 	 にぶら せ て
鈍ら せ た 	 にぶら せ た
復活 さ せる 	 ふっかつ さ せる
聴こえ て 	 きこえ て
生じ ない ように 	 しょうじ ない ように
途切れ て 	 とぎれ て
選曲 さ れ た 	 せんきょく さ れ た
発売 さ れ て 	 はつばい さ れ て
行う ように なり 	 おこなう ように なり
発展 する 	 はってん する
決定づける 	 けっていづける
決める 	 きめる
しゃぶしゃぶ する 	 しゃぶしゃぶ する
脱走 し た 	 だっそう し た
延期 する 	 えんき する
好み 	 このみ
盛り上がっ た 	 もりあがっ た
塞ぐ 	 ふさぐ
安心 でき ます 	 あんしん でき ます
提案 さ れ て 	 ていあん さ れ て
あい 	 あい
起こり まし た 	 おこり まし た
発生 	 はっせい
発電 し 	 はつでん し
蓄え て 	 たくわえ て
使う ようで ある 	 つかう ようで ある
注い 	 ちゅうい
飲む 	 のむ
評価 し て 	 ひょうか し て
出火 し て 	 しゅっか し て
尊敬 し て 	 そんけい し て
死ん だ 	 しん だ
辿り着く 	 たどりつく
駆け回る 	 かけまわる
適し た 	 てきし た
改良 さ れ た 	 かいりょう さ れ た
訴え 	 うったえ
言及 さ れ ない 	 げんきゅう さ れ ない
出店 し 	 しゅってん し
有る 	 ある
遭わ れ た 	 あわ れ た
被災 さ れ た 	 ひさい さ れ た
伺 える 	 うかが える
指定 する 	 してい する
滅亡 する 	 めつぼう する
意味 し ませ ん 	 いみ し ませ ん
奪う 	 うばう
ご覧いただ け ます 	 ごらん いただけ ます
行き たく なく なる 	 いき たく なく なる
練り込ま れる 	 ねりこま れる
喧嘩 せ ず 	 けんか せ ず
好む 	 このむ
頼み ませ ん 	 たのみ ませ ん
紹介 さ れ て 	 しょうかい さ れ て
通い だし た 	 かよい だし た
張っ て 	 はっ て
押し 	 おし
繰り出す 	 くりだす
変化 する 	 へんか する
運ん だ 	 はこん だ
通す 	 とおす
入れ よう 	 いれ よう
出陣 し て 	 しゅつじん し て
つまん 	 つまん
歓迎 する 	 かんげい する
収め 	 おさめ
外れ て 	 はずれ て
たぶらかし 	 たぶらかし
投げ させ た 	 なげ させ た
信用 し て 	 しんよう し て
勧誘 さ れる 	 かんゆう さ れる
憂慮 さ れる べき 	 ゆうりょ さ れる べき
座視 し がたい 	 ざし し がたい
反映 し た 	 はんえい し た
整える 	 ととのえる
生じ た 	 しょうじ た
任せる 	 まかせる
介する 	 かいする
開始 さ れ た 	 かいし さ れ た
解決 さ れる 	 かいけつ さ れる
届き まし た 	 とどき まし た
及び 	 および
企図 	 きと
固まら ず 	 かたまら ず
呼応 する 	 こおう する
攻め られ た 	 せめ られ た
脱出 	 だっしゅつ
運営 さ れ て 	 うんえい さ れ て
通い 出す 	 かよい だす
支え た 	 ささえ た
迎え て 	 むかえ て
特筆 し た 	 とくひつ し た
収める 	 おさめる
支持 する 	 しじ する
宿泊 し た 	 しゅくはく し た
利用 	 りよう
楽しん だ 	 たのしん だ
契約 し て 	 けいやく し て
観る 	 みる
呼称 し て 	 こしょう し て
統括 し て 	 とうかつ し て
成長 し た 	 せいちょう し た
爆発 さ せ た 	 ばくはつ さ せ た
判っ て 	 わかっ て
許可 し 続ける 	 きょか し つづける
委嘱 し た 	 いしょく し た
展示 さ れる 	 てんじ さ れる
圧迫 する 	 あっぱく する
施行 し た 	 しこう し た
減少 	 げんしょう
出会い 	 であい
出す ように なり まし た 	 だす ように なり まし た
迫り 	 せまり
し かけ 	 し かけ
やり返し て 	 やりかえし て
さ れ ず 	 さ れ ず
噴射 する 	 ふんしゃ する
激突 	 げきとつ
融合 し た 	 ゆうごう し た
引き寄せ 	 ひきよせ
破壊 する 	 はかい する
減っ て 	 へっ て
初演 さ れ た 	 しょえん さ れ た
延期 さ れ て 	 えんき さ れ て
上演 さ れ て 	 じょうえん さ れ て
癒す 	 いやす
延期 さ れ 	 えんき さ れ
選出 する 	 せんしゅつ する
こぎつけ た 	 こぎつけ た
休刊 	 きゅうかん
囲ま れ 	 かこま れ
行き届き 	 ゆきとどき
見せつけ て 	 みせつけ て
埋葬 さ れ た 	 まいそう さ れ た
移葬 さ れ た 	 いそう さ れ た
成立 し ない 	 せいりつ し ない
休みし て 	 やすみし て
自覚 し て 	 じかく し て
出会っ て 	 であっ て
説き 	 とき
用いる ように 	 もちいる ように
希望 し て 	 きぼう し て
分散 し た 	 ぶんさん し た
保つ 	 たもつ
助ける 	 たすける
練習 する 	 れんしゅう する
入団 	 にゅうだん
投稿 する 	 とうこう する
試みれ 	 しみれ
成功 する 	 せいこう する
立ち並ん 	 たちならん
封鎖 し た 	 ふうさ し た
認める よう 	 みとめる よう
要求 する 	 ようきゅう する
受け継が れ た 	 うけつが れ た
決済 する 	 けっさい する
同封 さ れ た 	 どうふう さ れ た
記入 し 	 きにゅう し
送金 する 	 そうきん する
知り たく て 	 しり たく て
逃し た 	 のがし た
コメント し 	 こめんと し
合同 し て 	 ごうどう し て
創設 さ れ て 	 そうせつ さ れ て
見 られ ない 	 み られ ない
検討 せ ざるを得 ない 	 けんとう せ ざるをえ ない
申し添え ます 	 もうしそえ ます
関連付け て 	 かんれんづけ て
解釈 する 	 かいしゃく する
頼ま れ て 	 たのま れ て
下り たら 	 おり たら
分から ない ように 	 わから ない ように
強い られ そうだ 	 しい られ そうだ
採 れ た 	 と れ た
通行 する ような 	 つうこう する ような
普及 し て 	 ふきゅう し て
申し入れ た よう です 	 もうしいれ た よう です
回答 でき ませ ん 	 かいとう でき ませ ん
回答 し た 	 かいとう し た
変わら ず 	 かわら ず
追加 し 	 ついか し
増加 し た 	 ぞうか し た
減少 し て 	 げんしょう し て
相談 くださ ませ 	 そうだん くださ ませ
的中 し 	 てきちゅう し
挟み 	 はさみ
見守る 	 みまもる
済む よう 	 すむ よう
祈る 	 いのる
守ら れ た 	 まもら れ た
遭い まし た 	 あい まし た
波及 する 	 はきゅう する
感じ られ ず 	 かんじ られ ず
敵視 し て 	 てきし し て
拡張 し て 	 かくちょう し て
まぶし た 	 まぶし た
頼み まし た 	 たのみ まし た
出さ れ て 	 ださ れ て
服用 し たら 	 ふくよう し たら
選出 さ れる 	 せんしゅつ さ れる
列席 する 	 れっせき する
わかり ませ ん 	 わかり ませ ん
飛行 する 	 ひこう する
崇拝 する 	 すうはい する
劣ら ず 	 おとら ず
愛し て 	 あいし て
振っ て 	 ふっ て
助走 する 	 じょそう する
失墜 	 しっつい
前後 し て 	 ぜんご し て
消し た 	 けし た
殺さ れる 	 ころさ れる
見せ られ た 	 みせ られ た
処刑 さ れ て 	 しょけい さ れ て
吹い て 	 ふい て
予約 でき まし た 	 よやく でき まし た
集中 し て 	 しゅうちゅう し て
指摘 	 してき
慌て て 	 あわて て
交渉 し 	 こうしょう し
約束 し た 	 やくそく し た
囲ま れ た 	 かこま れ た
生かし 	 いかし
越し て 	 こし て
にらみ 	 にらみ
提供 さ れ て 	 ていきょう さ れ て
溜まっ て 	 たまっ て
楽になり まし た 	 らくになり まし た
変え られる 	 かえ られる
かり まし た 	 かり まし た
即位 し 	 そくい し
称し た 	 しょうし た
勤務 	 きんむ
発展 	 はってん
示唆 し て 	 しさ し て
埋め 込ま れ た 	 うめ こま れ た
接触 さ せる 	 せっしょく さ せる
起動 する 	 きどう する
検索 し て 	 けんさく し て
出 かけ て 	 で かけ て
見 まし た 	 み まし た
すき 	 すき
縛ら れ た 	 しばら れ た
解い て 	 とい て
図り 	 はかり
襲いかかる 	 おそいかかる
辿り 	 たどり
照らさ れ た 	 てらさ れ た
降臨 さ せ て 	 こうりん さ せ て
頑張ら なければ なら ない 	 がんばら なければ なら ない
強調 	 きょうちょう
話す ような 	 はなす ような
費やし た 	 ついやし た
寵愛 さ れ 	 ちょうあい さ れ
扱わ れる 	 あつかわ れる
くださっ た 	 くださっ た
頼む 	 たのむ
かけ 直し て 	 かけ なおし て
評価 し 	 ひょうか し
先読み する 	 さきよみ する
倒さ れ 	 たおさ れ
防 げ なく なり 	 ふせ げ なく なり
投げつける 	 なげつける
分ける 	 わける
大別 できる 	 たいべつ できる
増加 し て 	 ぞうか し て
やら せ て 	 やら せ て
見 直す 	 み なおす
準備 	 じゅんび
けん制 する 	 けんせい する
あきらめ て 	 あきらめ て
帰っ たら 	 かえっ たら
落ち て 	 おち て
出版 さ れ た 	 しゅっぱん さ れ た
発展 し た 	 はってん し た
使い やすく 	 つかい やすく
要望 し て 	 ようぼう し て
細分化 し て 	 さいぶんか し て
貸し出す 	 かしだす
先送り する 	 さきおくり する
借りる 	 かりる
育て た 	 そだて た
走ら せ 	 はしら せ
対戦 さ せる 	 たいせん さ せる
封じ た 	 ふうじ た
しても 	 しても
出現 する だろ う 	 しゅつげん する だろ う
卒業 し て 	 そつぎょう し て
戻り 	 もどり
暮らし た そうです 	 くらし た そうです
議論 する 	 ぎろん する
保有 	 ほゆう
通り抜ける 	 とおりぬける
辞任 し て 	 じにん し て
就任 し まし た 	 しゅうにん し まし た
はぐれ て 	 はぐれ て
契約 でき まし た 	 けいやく でき まし た
移動 し て 	 いどう し て
信じ 込ん 	 しん じこん
認定 さ れ て 	 にんてい さ れ て
生息 する 	 せいそく する
共用 できる 	 きょうよう できる
消し飛ぶ 	 けしとぶ
連れ られ て 	 つれ られ て
気づか れ ない 	 きづか れ ない
さ せ られ 	 さ せ られ
応対 し た 	 おうたい し た
帰宅 	 きたく
寄せ られ 	 よせ られ
進め 	 すすめ
進め られ た 	 すすめ られ た
廃車 さ れ 	 はいしゃ さ れ
営業 し て 	 えいぎょう し て
おい た 	 おい た
残 せ て 	 のこ せ て
浮かべ た 	 うかべ た
硬化 さ せ た 	 こうか さ せ た
決断 	 けつだん
気に入っ ちゃい ます 	 きにいっ ちゃい ます
辞し 	 じし
混迷 し 	 こんめい し
出し抜か れ た 	 だしぬか れ た
つこ う 	 つこ う
並行 し て 	 へいこう し て
勃興 し 	 ぼっこう し
図る べき だ 	 はかる べき だ
阻む 	 はばむ
拠れ 	 これ
落とせ 	 おとせ
積み上げ て 	 つみあげ て
つかみ 	 つかみ
とれ ませ ん 	 とれ ませ ん
献金 し なさい 	 けんきん し なさい
長け て 	 たけ て
売ら れ て 	 うら れ て
行き ませ ん 	 いき ませ ん
ひかえる 	 ひかえる
渡しし て 	 わたしし て
相談 	 そうだん
締結 し 	 ていけつ し
砲撃 し て 	 ほうげき し て
かけ た 	 かけ た
託し て 	 たくし て
で て 	 で て
流行 し 	 りゅうこう し
挿入 し て 	 そうにゅう し て
崩れ 	 くずれ
つき ます 	 つき ます
交付 さ れる 	 こうふ さ れる
養わ れる 	 やしなわ れる
食べ やすい 	 たべ やすい
委ね られ た 	 ゆだね られ た
協議 さ れ ます 	 きょうぎ さ れ ます
訪ねる 	 たずねる
照れ 	 てれ
恋する 	 こいする
制作 さ れ た 	 せいさく さ れ た
統合 し て 	 とうごう し て
沿い 	 ぞい
修練 する 	 しゅうれん する
強化 	 きょうか
着手 し 	 ちゃくしゅ し
開通 済み 	 かいつう ずみ
追い 	 おい
感じ まし た 	 かんじ まし た
聞き取 れる 	 ききと れる
創設 さ れ 	 そうせつ さ れ
競う 	 きそう
酷似 し て 	 こくじ し て
成立 する 	 せいりつ する
意味 し て 	 いみ し て
言わ なかっ た 	 いわ なかっ た
務め 	 つとめ
投稿 さ れ た 	 とうこう さ れ た
控え させ て 	 ひかえ させ て
殺す 	 ころす
逃がし て 	 にがし て
兼ねる 	 かねる
点灯 さ せ 続け て 	 てんとう さ せ つづけ て
プレイ する 	 ぷれい する
装着 する 	 そうちゃく する
付属 し て 	 ふぞく し て
選択 できる 	 せんたく できる
厳選 し て 	 げんせん し て
取り寄せ て 	 とりよせ て
味わ える 	 あじわ える
所属 せ ず 	 しょぞく せ ず
フォロー し て 	 ふぉろー し て
進ま ない 	 すすま ない
楽し める 	 たのし める
特定 し た 	 とくてい し た
いける 	 いける
説明 す べき でしょ う 	 せつめい す べき でしょ う
がっかりし て 	 がっかりし て
湿っ た 	 しめっ た
入ら ない 	 はいら ない
撮影 さ れ て 	 さつえい さ れ て
移植 さ れ て 	 いしょく さ れ て
救援 し た 	 きゅうえん し た
想起 さ せる 	 そうき さ せる
深化 し 	 しんか し
完成 する 	 かんせい する
望 める 	 のぞ める
広げ た 	 ひろげ た
渋滞 する 	 じゅうたい する
引っ越し て 	 ひっこし て
行け ませ ん 	 いけ ませ ん
下し た 	 くだし た
敗退 し 	 はいたい し
演じる 	 えんじる
応対 し て 	 おうたい し て
指定 さ れる 	 してい さ れる
建築 でき ず 	 けんちく でき ず
加速 する 	 かそく する
覆 せる 	 くつがえ せる
譲渡 し た 	 じょうと し た
雇用 さ れ た 	 こよう さ れ た
要請 し て 	 ようせい し て
着手 さ せ なけれ 	 ちゃくしゅ さ せ なけれ
確保 でき ない 	 かくほ でき ない
足り ない 	 たり ない
攻撃 し 	 こうげき し
いたる 	 いたる
渡河 し 	 とか し
拠っ て 	 よっ て
追い込み 	 おいこみ
降伏 さ せ た 	 こうふく さ せ た
応用 する 	 おうよう する
期待 できる 	 きたい できる
開設 し 	 かいせつ し
納め た 	 おさめ た
コミュニケーション する 	 こみゅにけーしょん する
学 べ ます 	 まな べ ます
動かし て 	 うごかし て
鑑賞 し た 	 かんしょう し た
聴い て 	 きい て
議論 し て 	 ぎろん し て
代表 さ れる 	 だいひょう さ れる
運用 し て 	 うんよう し て
配備 さ れ て 	 はいび さ れ て
期待 し た 	 きたい し た
ご覧下さい 	 ごらんください
演奏 さ れる 	 えんそう さ れる
交渉 し て 	 こうしょう し て
見せ なく なっ 	 みせ なく なっ
とれ なく なっ た 	 とれ なく なっ た
招集 さ れ 	 しょうしゅう さ れ
期待 さ れ て 	 きたい さ れ て
占め られ て 	 しめ られ て
こみあげ て 	 こみあげ て
恐れ入っ た 	 おそれいっ た
失敗 し まし た 	 しっぱい し まし た
待ち伏せ さ れる 	 まちぶせ さ れる
訳 し た 	 やく し た
認定 さ れ 	 にんてい さ れ
軽んじ られ た 	 かろんじ られ た
出来 	 でき
経っ て 	 たっ て
歩き 	 あるき
疲れ た 	 つかれ た
向かい 	 むかい
移動 さ せ た 	 いどう さ せ た
抹殺 さ れ て 	 まっさつ さ れ て
確保 	 かくほ
押し切ら れ た 	 おしきら れ た
解決 する 	 かいけつ する
付け加え た 	 つけくわえ た
署名 さ れ た 	 しょめい さ れ た
強い られ た 	 しい られ た
送り込み 	 おくりこみ
運転 さ れ た 	 うんてん さ れ た
入り込む 	 はいりこむ
刊行 し 	 かんこう し
使い 	 つかい
語りかけ て 	 かたりかけ て
救出 さ れ た 	 きゅうしゅつ さ れ た
匿わ れ て 	 かくまわ れ て
押し寄せ て 	 おしよせ て
チャレンジ し て 	 ちゃれんじ し て
吸収 し た 	 きゅうしゅう し た
消費 し て 	 しょうひ し て
預け られ た 	 あずけ られ た
否定 し 	 ひてい し
染め 	 そめ
あげる 	 あげる
間違っ て 	 まちがっ て
迎え入れる 	 むかえいれる
優先 する 	 ゆうせん する
追いつい た 	 おいつい た
解任 さ れ た 	 かいにん さ れ た
指名 さ れ 	 しめい さ れ
承認 さ れ た 	 しょうにん さ れ た
負け ない 	 まけ ない
うるおい 	 うるおい
満ち た 	 みち た
施術 する 	 しじゅつ する
傷め ませ ん 	 いため ませ ん
稼働 	 かどう
渡米 	 とべい
完成 し た 	 かんせい し た
逮捕 さ れ て 	 たいほ さ れ て
開ける 	 ひらける
推進 する 	 すいしん する
赴任 し た 	 ふにん し た
訴える 	 うったえる
渡し て 	 わたし て
拭っ た 	 ぬぐっ た
発表 し ない 	 はっぴょう し ない
抑制 する 	 よくせい する
締めくくっ た 	 しめくくっ た
頭突き し 	 ずつき し
利用 し 	 りよう し
し かける 	 し かける
掴み 	 つかみ
切断 し て 	 せつだん し て
いわ れ 	 いわ れ
控える よう 	 ひかえる よう
堪能 できる 	 たんのう できる
予告 し て 	 よこく し て
外し て 	 はずし て
で 出す 	 で だす
銘打っ た 	 めいうっ た
見せ なかっ た ようだ 	 みせ なかっ た ようだ
連立 する 	 れんりつ する
亡くなる 	 なくなる
失くし た 	 うしなくし た
改題 さ れ 	 かいだい さ れ
痩せこけ た 	 やせこけ た
間違え られ 	 まちがえ られ
煽ら れ て 	 あおら れ て
変装 し た 	 へんそう し た
生まれる らしい 	 うまれる らしい
減少 し た 	 げんしょう し た
召し上げ 	 めしあげ
分け与え た 	 わけあたえ た
処分 さ れ た 	 しょぶん さ れ た
思わ れ て 	 おもわ れ て
大破 し た 	 たいは し た
漂流 し て 	 ひょうりゅう し て
発見 し 	 はっけん し
写真撮影 し た 	 しゃしんさつえい し た
凝り すぎる 	 こり すぎる
派生 	 はせい
アップグレード し まし た 	 あっぷぐれーど し まし た
暮らし た 	 くらし た
配属 	 はいぞく
かかり ます 	 かかり ます
結 べ て 	 むす べ て
駐車 し た 	 ちゅうしゃ し た
酔っ た 	 よっ た
起こし 	 おこし
判明 し た 	 はんめい し た
尽力 し 	 じんりょく し
授与 さ れ 	 じゅよ さ れ
讃え られ た 	 たたえ られ た
混ん だら 	 こん だら
来 ない 	 こ ない
下さ れる 	 くださ れる
進行 する 	 しんこう する
操作 する 	 そうさ する
くださっ 	 くださっ
くれる 	 くれる
結婚 し 	 けっこん し
住ん だ 	 すん だ
筆写 さ せ た 	 ひっしゃ さ せ た
弾劾 さ れ 	 だんがい さ れ
降格 する 	 こうかく する
証明 する 	 しょうめい する
言い換えれ 	 こといかえれ
呼称 さ れ た 	 こしょう さ れ た
制し た 	 せいし た
勝っ た 	 かっ た
願いし ます 	 ねがいし ます
表明 さ れ 	 ひょうめい さ れ
封じ込める 	 ふうじこめる
拠出 する 	 きょしゅつ する
寝る 	 ねる
見に行き まし た 	 みにいき まし た
紹介 さ れる 	 しょうかい さ れる
実在 する 	 じつざい する
付く ように なっ た 	 つく ように なっ た
立身出世 し た 	 りっしんしゅっせ し た
預け られ 	 あずけ られ
赴く 	 おもむく
実証 し た 	 じっしょう し た
交わし 	 かわし
繋がり ます 	 つながり ます
つなぎ 	 つなぎ
整形 さ れる 	 せいけい さ れる
リリース さ れ た 	 りりーす さ れ た
中止 	 ちゅうし
上映 	 じょうえい
オープン さ せる 	 おーぷん さ せる
書きとめ よう 	 かきとめ よう
収録 し て 	 しゅうろく し て
搬送 さ れ た 	 はんそう さ れ た
承認 さ れ 	 しょうにん さ れ
施行 さ れ た 	 しこう さ れ た
応援 する 	 おうえん する
統一 し 	 とういつ し
放つ 	 はなつ
生まれ 	 うまれ
出版 	 しゅっぱん
下校 し まし た 	 げこう し まし た
準じ た 	 じゅんじ た
変更 さ れ 	 へんこう さ れ
拡大 さ れ て 	 かくだい さ れ て
暗殺 さ れ た 	 あんさつ さ れ た
失敗 し 	 しっぱい し
締めくくる 	 しめくくる
し たいです 	 し たいです
縦走 する 	 じゅうそう する
出場 し 	 しゅつじょう し
惚れ て 	 ぼれ て
演奏 し 	 えんそう し
こぎれ 	 こぎれ
いで 	 いで
清掃 さ れ て 	 せいそう さ れ て
あらわ せる 	 あらわ せる
楽しみ まし た 	 たのしみ まし た
展示 さ れ て 	 てんじ さ れ て
講習 	 こうしゅう
味わっ た 	 あじわっ た
行き届い て 	 いきとどい て
達し ない 	 たっし ない
発育 し ない 	 はついく し ない
めざし て 	 めざし て
入賞 し 	 にゅうしょう し
説明 さ れ 	 せつめい さ れ
震える 	 ふるえる
走 れる 	 はし れる
誘わ れ て 	 さそわ れ て
あおる 	 あおる
断た れ て 	 たた れ て
走 し て 	 はし し て
攻め られ 	 せめ られ
軽量化 さ れ 	 けいりょうか さ れ
持ち 続け て 	 もち つづけ て
なら なく なっ た 	 なら なく なっ た
揺らめき 	 ゆらめき
覚える 	 おぼえる
言い残し 	 いいのこし
評 する 	 ひょう する
忘れ た 	 わすれ た
回答 さ せ て 	 かいとう さ せ て
やり直す 	 やりなおす
取り入れる ように なる 	 とりいれる ように なる
叩き込ん だ 	 たたきこん だ
かけ られ 	 かけ られ
とら ない 	 とら ない
分かち 合い 	 わかち あい
演じ きっ た 	 えんじ きっ た
購入 し 	 こうにゅう し
転居 する 	 てんきょ する
公開 し て 	 こうかい し て
つづら れる 	 つづら れる
割か れ て 	 さか れ て
浴びる 	 あびる
完治 し た 	 かんち し た
楽しみ たい 	 たのしみ たい
空い て 	 あい て
暗殺 する 	 あんさつ する
帰順 し た 	 きじゅん し た
サボる 	 さぼる
許さ れ ない 	 ゆるさ れ ない
扱っ た 	 あつかっ た
分かれ た 	 わかれ た
縮小 し て 	 しゅくしょう し て
構築 し よう 	 こうちく し よう
消滅 し て 	 しょうめつ し て
唖然とさ せ た 	 あぜんとさ せ た
夭折 し た 	 ようせつ し た
建設 する 	 けんせつ する
取り壊さ れ た 	 とりこわさ れ た
疎ま れる 	 うとま れる
疎ま れ 	 うとま れ
損ねる 	 そこねる
わから なかっ た 	 わから なかっ た
設置 し 	 せっち し
生産 し て 	 せいさん し て
始め た 	 はじめ た
悩まさ れ て 	 なやまさ れ て
電話 する 	 でんわ する
集まる 	 あつまる
公募 する 	 こうぼ する
名乗り出 ない 	 なのりで ない
晒し 	 さらし
置か れ 	 おか れ
頼る べき で 	 たよる べき で
受け継が れる 	 うけつが れる
減少 し 	 げんしょう し
克服 し た 	 こくふく し た
活躍 できる ように なっ た 	 かつやく できる ように なっ た
撮影 し ない 	 さつえい し ない
説明 する そうです 	 せつめい する そうです
塞がれ 	 ふさがれ
なり たく なけれ 	 なり たく なけれ
捨て 	 すて
脱ぎ 	 ぬぎ
棄て て 	 すて て
泳ぐ 	 およぐ
プレゼント し ます 	 ぷれぜんと し ます
契約 し まし た 	 けいやく し まし た
称する 	 しょうする
な れ ませ ん 	 な れ ませ ん
作用 する 	 さよう する
証明 さ れ て 	 しょうめい さ れ て
導入 さ れ 	 どうにゅう さ れ
沿っ て 	 そっ て
割り振ら れ た 	 わりふら れ た
下回っ た 	 したまわっ た
到着 	 とうちゃく
留まっ た 	 とまっ た
始め て 	 はじめ て
移行 し た 	 いこう し た
手伝う 	 てつだう
修復 する 	 しゅうふく する
誘拐 さ れる 	 ゆうかい さ れる
救出 さ れる 	 きゅうしゅつ さ れる
発布 さ れ た 	 はっぷ さ れ た
fax さ れ て 	 ＦＡＸ さ れ て
愛さ れ た 	 あいさ れ た
行わ れ まし た 	 おこなわ れ まし た
露呈 し まし た 	 ろてい し まし た
廻っ て 	 まわっ て
守る べき であり 	 まもる べき であり
殺到 し 	 さっとう し
超え た 	 こえ た
受け ない 	 うけ ない
起こり やすい 	 おこり やすい
護る 	 まもる
うっ て 	 うっ て
なさ れ て 	 なさ れ て
製作 さ れ た 	 せいさく さ れ た
わから なく 	 わから なく
成立 さ せる 	 せいりつ さ せる
効い た 	 きい た
買っ た らしく 	 かっ た らしく
供与 さ れ た 	 きょうよ さ れ た
投稿 し まし た 	 とうこう し まし た
捉え て 	 とらえ て
居 	 い
保留 し た 	 ほりゅう し た
攻め 	 せめ
断絶 	 だんぜつ
イメージ し 	 いめーじ し
誕生 し まし た 	 たんじょう し まし た
並ん だ 	 ならん だ
来 まし た 	 き まし た
育て ます 	 そだて ます
食べ 切っ たら 	 たべ きっ たら
いえ ませ ん 	 いえ ませ ん
立ち寄 れる 	 たちよ れる
変身 する 	 へんしん する
不足 する 	 ふそく する
申し込み 	 もうしこみ
開幕 	 かいまく
いえ よう 	 いえ よう
進出 し た 	 しんしゅつ し た
破り 	 やぶり
診断 する 	 しんだん する
失わ れ た 	 うしなわ れ た
編成 する 	 へんせい する
研究 さ れ て 	 けんきゅう さ れ て
おら れ 	 おら れ
小屋掛け さ せ ない 	 こやかけ さ せ ない
分け 	 わけ
遵守 さ れ た 	 じゅんしゅ さ れ た
移転 	 いてん
取得 し 	 しゅとく し
ねる 	 ねる
立ち 	 だち
後ろ向き 	 うしろむき
配置 さ れ た 	 はいち さ れ た
転換 し て 	 てんかん し て
侵害 さ れ た 	 しんがい さ れ た
過ごさ ざるを得 なかっ た 	 すごさ ざるをえ なかっ た
作成 さ れ た 	 さくせい さ れ た
配布 さ れ て 	 はいふ さ れ て
組み込ま れ て 	 くみこま れ て
隠 せ ない 	 かく せ ない
かかわる 	 かかわる
撮り 	 とり
通報 し て 	 つうほう し て
確定 する 	 かくてい する
要請 し た 	 ようせい し た
移し た 	 うつし た
さまよっ た 	 さまよっ た
みつけ た 	 みつけ た
引越 する なら 	 ひっこし する なら
任せ られる 	 まかせ られる
追加 さ れ 	 ついか さ れ
扱 え ない 	 あつか え ない
レコーディング し た 	 れこーでぃんぐ し た
本格化 する 	 ほんかくか する
みる 	 みる
羅列 さ れ て 	 られつ さ れ て
供給 	 きょうきゅう
持ち歩き 	 もちあるき
挟む 	 はさむ
受け入れ られ なかっ た 	 うけいれ られ なかっ た
済み で ない 	 ずみ で ない
申込み 	 もうしこみ
発散 し た 	 はっさん し た
亡くなら れ 	 なくなら れ
負わ れ 	 おわ れ
おら れ ます 	 おら れ ます
確保 さ れ て 	 かくほ さ れ て
購入 さ せ 	 こうにゅう さ せ
配り 	 くばり
歩か せ て 	 あるか せ て
統括 する 	 とうかつ する
おこない 	 おこない
引き起こし て 	 ひきおこし て
区切ら れ て 	 くぎら れ て
診察 	 しんさつ
聞こえ ます 	 きこえ ます
はめ られ て 	 はめ られ て
反対 し て 	 はんたい し て
歴任 し て 	 れきにん し て
増やし 	 ふやし
来店 できる 	 らいてん できる
もたらさ ない 	 もたらさ ない
停車 する 	 ていしゃ する
乗り出す 	 のりだす
配ら れ て 	 くばら れ て
組ん 	 くみん
遂げ た 	 とげ た
当面 	 とうめん
限定 さ れ て 	 げんてい さ れ て
契約 	 けいやく
助かり まし た 	 たすかり まし た
口走っ て 	 くちばしっ て
禁じる 	 きんじる
見とがめ られる 	 みとがめ られる
言い そうな 	 いい そうな
想像 し て 	 そうぞう し て
規定 し て 	 きてい し て
亘っ て 	 わたっ て
わかり 	 わかり
せ ん 	 せ ん
置い とい て 	 おい とい て
効い て 	 きい て
移築 さ れ て 	 いちく さ れ て
申請 し て 	 しんせい し て
選定 し て 	 せんてい し て
答申 する よう 	 とうしん する よう
諮問 し た 	 しもん し た
望む 	 のぞむ
勤務 し て 	 きんむ し て
分布 し 	 ぶんぷ し
利用 さ れる ように なっ た 	 りよう さ れる ように なっ た
立た ない 	 たた ない
調える 	 ととのえる
擁立 さ れ 	 ようりつ さ れ
追放 する 	 ついほう する
引き立て られ た 	 ひきたて られ た
呼称 さ れる 	 こしょう さ れる
いただき 	 いただき
見つける 	 みつける
組織 し よう 	 そしき し よう
見つから ず 	 みつから ず
集め られ 	 あつめ られ
加え られ て 	 くわえ られ て
呼び戻さ れる 	 よびもどさ れる
費やす 	 ついやす
目立っ て 	 めだっ て
わから ず 	 わから ず
発着 する 	 はっちゃく する
救助 し た 	 きゅうじょ し た
発射 し た 	 はっしゃ し た
爆発 し た 	 ばくはつ し た
再会 し た 	 さいかい し た
始まっ て 	 はじまっ て
分かれる 	 わかれる
賜っ た 	 たまものっ た
奪い 	 うばい
還り 	 かえり
属役 さ せ た 	 ぞくえき さ せ た
もめ た 	 もめ た
辞退 し 	 じたい し
審議 さ れ 	 しんぎ さ れ
意思決定 し 	 いしけってい し
採決 さ れる 	 さいけつ さ れる
垣間見 え た 	 かきまみ え た
復活 し た 	 ふっかつ し た
追い込ま れ 	 おいこま れ
撒か せ よう 	 まか せ よう
巻き込ま れ て 	 まきこま れ て
消す 	 けす
通り過ぎる 	 とおりすぎる
付加 し 	 ふか し
付加 する 	 ふか する
裏切ら ない 	 うらぎら ない
乗じ て 	 のじ て
決定 	 けってい
とまる 	 とまる
発生 し 	 はっせい し
立ち上げ られ 	 たちあげ られ
広げ られ た 	 ひろげ られ た
媚びへつらう 	 こびへつらう
廃し て 	 すたし て
書き換え られ た 	 かきかえ られ た
対立 する 	 たいりつ する
説得 し 	 せっとく し
調整 し て 	 ちょうせい し て
操作 し 	 そうさ し
巻き込ま れる 	 まきこま れる
勝利 し 	 しょうり し
成長 する 	 せいちょう する
宿る 	 やどる
満足 する 	 まんぞく する
もどる 	 もどる
視察 し て 	 しさつ し て
批判 す べき 	 ひはん す べき
見 出し た 	 み いだし た
付け ず 	 つけ ず
焼き 	 やき
頼み ませ ん でした 	 たのみ ませ ん でした
持と う 	 もと う
始め られ た 	 はじめ られ た
主張 する 	 しゅちょう する
押し寄せる 	 おしよせる
記載 する 	 きさい する
送信 する 	 そうしん する
反する 	 はんする
掛かっ て 	 かかっ て
問わ れ た 	 とわ れ た
擁護 し た 	 ようご し た
指定 さ れ 	 してい さ れ
主演 し た 	 しゅえん し た
擁する 	 ようする
離 せ ませ ん 	 はな せ ませ ん
抹消 さ れ た 	 まっしょう さ れ た
キャンプ 	 きゃんぷ
見舞わ れ た 	 みまわ れ た
励まそ う 	 はげま そう
精通 し て 	 せいつう し て
思え まし た 	 おもえ まし た
静止 し て 	 せいし し て
潰れ て 	 つぶれ て
執り 	 とり
修理 し た 	 しゅうり し た
主張 し 	 しゅちょう し
外れる ように なり 	 はずれる ように なり
持つ ように なっ て 	 もつ ように なっ て
張り付く 	 はりつく
発射 する 	 はっしゃ する
かかり やすい 	 かかり やすい
分かっ て 	 わかっ て
差し替え 	 さしかえ
わかり ます 	 わかり ます
起こら ず 	 おこら ず
活動 し た 	 かつどう し た
終え て 	 おえ て
帰投 	 きとう
刃向かう 	 はむかう
挙げ られ 	 あげ られ
あげ られる 	 あげ られる
受け入れ 	 うけいれ
強まり 	 つよまり
中断 し て 	 ちゅうだん し て
再開 し た 	 さいかい し た
働か せ 続け 	 はたらか せ つづけ
奪い取り 	 うばいとり
信じる 	 しんじる
送 らさ れ て 	 おく らさ れ て
伺い まし た 	 うかがい まし た
訪れ よう 	 おとずれ よう
先取り し て 	 さきどり し て
動い て 	 うごい て
固定 さ れ て 	 こてい さ れ て
動か せ ない 	 うごか せ ない
削ら れ て 	 けずら れ て
抽出 し て 	 ちゅうしゅつ し て
集計 する 	 しゅうけい する
まとめ 	 まとめ
負担 し た 	 ふたん し た
下っ た 	 くだっ た
斬り 	 ぎり
通じ なかっ た 	 つうじ なかっ た
おびき出さ れ 	 おびきださ れ
許さ れ て 	 ゆるさ れ て
電話 し た 	 でんわ し た
切り まし た 	 きり まし た
乱れ た 	 みだれ た
行なっ た 	 おこなっ た
跨ぐ 	 またぐ
遭う 	 あう
絞り 	 しぼり
巡り 	 めぐり
繰り広げる 	 くりひろげる
殴ら れ た ような 	 なぐら れ た ような
考え た らしく 	 かんがえ た らしく
大勝 し 	 たいしょう し
賭け た 	 かけ た
挑ん だ 	 いどん だ
付け られ 	 つけ られ
巻き返す 	 まきかえす
及ば ず 	 およば ず
制作 し た 	 せいさく し た
派遣 さ れ 	 はけん さ れ
到着 し て 	 とうちゃく し て
当選 し た 	 とうせん し た
作ろ う 	 つくろ う
提起 さ れ た 	 ていき さ れ た
開か れ た 	 ひらか れ た
気に入っ た ようで 	 きにいっ た ようで
亡命 し 	 ぼうめい し
仕え た 	 つかえ た
示唆 さ れ て 	 しさ さ れ て
悩み 続け 	 なやみ つづけ
疲れ果て て 	 つかれはて て
つまっ た 	 つまっ た
打っ た 	 うっ た
寄付 し た 	 きふ し た
広がり 	 ひろがり
発令 し 	 はつれい し
戦死 	 せんし
見 なさ れ て 	 み なさ れ て
回し 	 まわし
一転 	 いってん
移行 し て 	 いこう し て
暮れ た 	 くれ た
すぎ 	 すぎ
並べ た 	 ならべ た
燃え上がり 	 もえあがり
浮かびあがっ た 	 うかびあがっ た
い よう 	 い よう
刺し殺す 	 さしころす
大盤振る舞い する 	 おおばんぶるまい する
薄れ て 	 うすれ て
迫ら れ て 	 せまら れ て
割り当てる 	 わりあてる
去る 	 さる
提起 し た 	 ていき し た
生き延び た 	 いきのび た
通す ように 	 とおす ように
抜け 	 ぬけ
分岐 し た 	 ぶんき し た
上がら ず 	 あがら ず
破局 し た 	 はきょく し た
開始 する 	 かいし する
想定 し て 	 そうてい し て
転用 さ れる 	 てんよう さ れる
設立 さ れ て 	 せつりつ さ れ て
進行 し た 	 しんこう し た
寄与 し 	 きよ し
抑制 さ れ て 	 よくせい さ れ て
謳い 	 うたい
併呑 し て 	 へいどん し て
おろし て 	 おろし て
喋る 	 しゃべる
離れ 	 はなれ
見 合っ た 	 み あっ た
発動 さ れ なく なり 	 はつどう さ れ なく なり
増し 	 まし
走っ た 	 はしっ た
み なされ 	 み なされ
進ま なかっ た 	 すすま なかっ た
願いし たい 	 ねがいし たい
着用 し て 	 ちゃくよう し て
連載 し た 	 れんさい し た
征服 する 	 せいふく する
退ける 	 しりぞける
引き受ける 	 ひきうける
語り継い だ 	 かたりつい だ
隔て て 	 へだて て
推測 し て 	 すいそく し て
引き込ん だ 	 ひきこん だ
参っ た 	 まいっ た
登録 さ れ て 	 とうろく さ れ て
負け た 	 まけ た
出演 する 	 しゅつえん する
同じ 	 おなじ
飲ん だら 	 のん だら
見極め たい 	 みきわめ たい
走り 続け 	 はしり つづけ
止まる 	 とまる
発達 し 	 はったつ し
処理 し た 	 しょり し た
競う ように なっ た 	 きそう ように なっ た
信頼 でき ます 	 しんらい でき ます
数え て 	 かぞえ て
行か ない 	 いか ない
延長 する 	 えんちょう する
賛成 する 	 さんせい する
こん 	 こん
提訴 し た 	 ていそ し た
育て たい 	 そだて たい
成長 さ せる 	 せいちょう さ せる
頼 める 	 たの める
手慣れ た 	 てなれ た
比例 し て 	 ひれい し て
増加 	 ぞうか
廃止 し た 	 はいし し た
バトル する 	 ばとる する
敗北 し た 	 はいぼく し た
ほこり 	 ほこり
施し た 	 ほどこし た
配置 	 はいち
触れ ない ように する 	 ふれ ない ように する
活動 	 かつどう
抵抗 する 	 ていこう する
排除 し 	 はいじょ し
蔑視 し て 	 べっし し て
出品 さ れ て 	 しゅっぴん さ れ て
配布 する 	 はいふ する
目撃 さ れ そうだ 	 もくげき さ れ そうだ
名づけ られる 	 なづけ られる
呼ば れる ように なっ た 	 よば れる ように なっ た
訪問 し まし た 	 ほうもん し まし た
離脱 し よう 	 りだつ し よう
計画 	 けいかく
読み上げる 	 よみあげる
誓い ます 	 ちかい ます
蝕ま れ 	 しょくま れ
食べ させ 	 たべ させ
殺害 し よう 	 さつがい し よう
おちょくる 	 おちょくる
売っ て 	 うっ て
むせる ような 	 むせる ような
やみ 	 やみ
紹介 出来 ませ ん 	 しょうかい でき ませ ん
臨む 	 のぞむ
踏み込む 	 ふみこむ
表示 さ れ て 	 ひょうじ さ れ て
撤去 さ れ た 	 てっきょ さ れ た
保存 さ れ て 	 ほぞん さ れ て
譲ら ず 	 ゆずら ず
可決 し た 	 かけつ し た
飾っ 	 かざっ
設ける 	 もうける
凝らし て 	 こらし て
みこん 	 みこん
依頼 し まし た 	 いらい し まし た
衰弱 し 	 すいじゃく し
設け られ て 	 もうけ られ て
ちなみ 	 ちなみ
案内 し て 	 あんない し て
採用 さ れ た 	 さいよう さ れ た
指名 し た 	 しめい し た
考え られ た 	 かんがえ られ た
あがっ た 	 あがっ た
締まり 	 つまり
たまり 	 たまり
妨害 さ れ て 	 ぼうがい さ れ て
敷く 	 しく
連携 	 れんけい
検討 し て 	 けんとう し て
過ごし 	 すごし
生れ た 	 うまれ た
化け する 	 ばけ する
挑戦 し たい 	 ちょうせん し たい
掛け 続け て 	 かけ つづけ て
実現 でき ない 	 じつげん でき ない
入力 する 	 にゅうりょく する
想像 し がたい 	 そうぞう し がたい
回り 	 まわり
渡す 	 わたす
問い かけ 	 とい かけ
ある かもしれ ませ ん 	 ある かもしれ ませ ん
散策 する 	 さんさく する
同行 し て 	 どうこう し て
捕らえ られ た 	 とらえ られ た
幽閉 し 	 ゆうへい し
暴こ う 	 あば こう
計画 さ れ た 	 けいかく さ れ た
集まら ず 	 あつまら ず
至ら なかっ 	 いたら なかっ
漕ぎ付け た 	 こぎつけ た
着工 する 	 ちゃっこう する
決定 さ れ 	 けってい さ れ
着工 さ れ た 	 ちゃっこう さ れ た
低下 し 	 ていか し
鳴動 	 めいどう
そそのかさ れ 	 そそのかさ れ
共鳴 し 	 きょうめい し
立っ て 	 たっ て
行動 	 こうどう
逃がし た 	 にがし た
打倒 	 だとう
練る 	 ねる
問わ れ 	 とわ れ
立ち寄っ た 	 たちよっ た
特筆 する 	 とくひつ する
恐れる 	 おそれる
合体 する 	 がったい する
演じ た 	 えんじ た
酔い潰れる 	 よいつぶれる
出現 し て 	 しゅつげん し て
持って行く 	 もっていく
仕上げ て 	 しあげ て
化粧 	 けしょう
利用 できる よう 	 りよう できる よう
後退 し た 	 こうたい し た
吐露 し た 	 とろ し た
祝っ て 	 いわっ て
がんばる 	 がんばる
表示 し て 	 ひょうじ し て
降り やすい 	 ふり やすい
眺め 	 ながめ
入り まし た 	 はいり まし た
収め られ て 	 おさめ られ て
回復 し 	 かいふく し
健闘 し た 	 けんとう し た
逃す 	 のがす
行ける 	 いける
体験 し ましょ う 	 たいけん し ましょ う
進駐 し た 	 しんちゅう し た
失わ れ て 	 うしなわ れ て
発足 	 ほっそく
提案 する 	 ていあん する
隆起 し た 	 りゅうき し た
省略 さ れ て 	 しょうりゃく さ れ て
命中 さ せる 	 めいちゅう さ せる
承認 さ れ て 	 しょうにん さ れ て
広告 する 	 こうこく する
禁止 し て 	 きんし し て
保存 	 ほぞん
馳せ て 	 はせ て
取り込む 	 とりこむ
見せつけ られ ます 	 みせつけ られ ます
避け られる べき 	 さけ られる べき
指揮 せ ざるをえ ない 	 しき せ ざるをえ ない
成長 し て 	 せいちょう し て
歴任 	 れきにん
判明 	 はんめい
占う 	 うらなう
拡大 し て 	 かくだい し て
即し て 	 そくし て
常任 し て 	 じょうにん し て
建造 さ れ て 	 けんぞう さ れ て
チェック し たら 	 ちぇっく し たら
収納 する 	 しゅうのう する
乗り越え た 	 のりこえ た
つかえる 	 つかえる
萌え 	 もえ
点在 し て 	 てんざい し て
伝えし ましょ う 	 つたえし ましょ う
削除 し ない 	 さくじょ し ない
思え なかっ た 	 おもえ なかっ た
分裂 し た 	 ぶんれつ し た
笑わ ない 	 わらわ ない
相まっ て 	 あいまっ て
取り上げ られ て 	 とりあげ られ て
わかれ 	 わかれ
思い出す 	 おもいだす
エロス 	 えろす
思い浮かば なく なっ て 	 おもいうかば なく なっ て
予想 さ れ て 	 よそう さ れ て
開催 する 	 かいさい する
い 	 い
いる そうで 	 いる そうで
ケア し て 	 けあ し て
建設 し た 	 けんせつ し た
長期化 し 	 ちょうきか し
化 し た 	 か し た
交際 し て 	 こうさい し て
身ごもっ た 	 みごもっ た
判明 する 	 はんめい する
捨て た 	 すて た
出産 	 しゅっさん
レンダリング し て 	 れんだりんぐ し て
故障 する 	 こしょう する
報告 さ れ て 	 ほうこく さ れ て
表示 さ れ た 	 ひょうじ さ れ た
調整 し た 	 ちょうせい し た
予想 する 	 よそう する
報告 	 ほうこく
分かり にくい 	 わかり にくい
ほっこりする 	 ほっこりする
切り替える 	 きりかえる
仕える 	 つかえる
批判 する 	 ひはん する
投稿 し て 	 とうこう し て
題し た 	 だいし た
飛び出す 	 とびだす
対抗 し 	 たいこう し
擁立 し た 	 ようりつ し た
当たる 	 あたる
議論 し 	 ぎろん し
違う かもしれ ませ ん 	 ちがう かもしれ ませ ん
成立 し た 	 せいりつ し た
付属 し た 	 ふぞく し た
堪ら ない です 	 たまら ない です
出 ない 	 で ない
祈っ て 	 いのっ て
駆けつけ 	 かけつけ
飛び降り よう 	 とびおり よう
思いとどまる よう 	 おもいとどまる よう
説得 し た 	 せっとく し た
閉めろ 	 しめろ
拒絶 	 きょぜつ
考慮 し 	 こうりょ し
集計 し た 	 しゅうけい し た
破棄 する 	 はき する
代行 さ せ て 	 だいこう さ せ て
寄付 	 きふ
捏造 し た 	 ねつぞう し た
持ち上がっ た 	 もちあがっ た
連行 さ れ た 	 れんこう さ れ た
連絡 し 	 れんらく し
仰い だ 	 あおい だ
向上 し て 	 こうじょう し て
撮影 できる 	 さつえい できる
貯蔵 する 	 ちょぞう する
処理 し て 	 しょり し て
考案 さ れ て 	 こうあん さ れ て
普及 する ように なっ た 	 ふきゅう する ように なっ た
延びる 	 のびる
生い茂る 	 おいしげる
かき分け て 	 かきわけ て
弁明 する 	 べんめい する
流通 し て 	 りゅうつう し て
薦め です 	 すすめ です
背負っ た 	 せおっ た
一見 すれ 	 いっけん すれ
ガード する 	 がーど する
居 て 	 い て
入れ ない 	 いれ ない
入る よう 	 はいる よう
勧め た 	 すすめ た
配布 し た 	 はいふ し た
設計 さ れ た 	 せっけい さ れ た
取りかかっ て 	 とりかかっ て
立ち上がら なかっ た 	 たちあがら なかっ た
回答 	 かいとう
辞職 す べき 	 じしょく す べき
のぼっ て 	 のぼっ て
受け継ぐ 	 うけつぐ
貫通 し ない 	 かんつう し ない
倒せ 	 たおせ
進入 し 	 しんにゅう し
捜す 	 さがす
完了 し 	 かんりょう し
そろっ た 	 そろっ た
取れ 	 とれ
透き通っ て 	 すきとおっ て
刻み 	 きざみ
吸っ て 	 すっ て
きかせ た 	 きかせ た
集結 し た 	 しゅうけつ し た
勝ち抜き 	 かちぬき
奪わ れ そうに なっ て 	 うばわ れ そうに なっ て
殺害 し 	 さつがい し
服役 	 ふくえき
行わ ず 	 おこなわ ず
取り込ま れ た 	 とりこま れ た
聞き たく て 	 きき たく て
拡大 し 	 かくだい し
推進 さ れ て 	 すいしん さ れ て
読み上げ られ た 	 よみあげ られ た
要約 する 	 ようやく する
対処 する 	 たいしょ する
さめ 	 さめ
切り替え た 	 きりかえ た
変え て 	 かえ て
採用 する 	 さいよう する
安売り さ れ て 	 やすうり さ れ て
奪わ れ 	 うばわ れ
付く 	 つく
強化 する 	 きょうか する
下げ た 	 さげ た
おき し て 	 おき し て
冷め て 	 さめ て
狙い 	 ねらい
へ ん 	 へ ん
すん 	 すん
保護 し た 	 ほご し た
曲解 さ れる 	 きょっかい さ れる
発展 し 	 はってん し
駆使 し た 	 くし し た
転出 し 	 てんしゅつ し
裏付ける ように 	 うらづける ように
落選 	 らくせん
憎ん 	 にくん
強打 し て 	 きょうだ し て
侵略 し た 	 しんりゃく し た
反論 し て 	 はんろん し て
取れ ない 	 とれ ない
区分 する 	 くぶん する
要請 さ れる 	 ようせい さ れる
後述 する 	 こうじゅつ する
生ずる 	 しょうずる
全通 し て 	 ぜんつう し て
開通 し た 	 かいつう し た
要する 	 ようする
いえ ない 	 いえ ない
近付い た 	 ちかづい た
乗り入れ て 	 のりいれ て
表記 さ れる 	 ひょうき さ れる
従っ た 	 したがっ た
出場 し て 	 しゅつじょう し て
釣っ た 	 つっ た
贈ら れ 	 おくら れ
対戦 する 	 たいせん する
訪ね て 	 たずね て
刷り込み 	 すりこみ
終わっ ちゃう 	 おわっ ちゃう
撃ち 出さ れる 	 うち ださ れる
在住 する 	 ざいじゅう する
使用 さ せ て 	 しよう さ せ て
飛ぶ 	 とぶ
継続 さ れる 	 けいぞく さ れる
知り 	 ちり
入れ 	 いれ
捨て て 	 すて て
いき まし て 	 いき まし て
回顧 し て 	 かいこ し て
昇進 	 しょうしん
知ら れる ように なる 	 しら れる ように なる
陥没 する 	 かんぼつ する
押し込め られ た 	 おしこめ られ た
冷やかし て 	 ひややかし て
言っ た 	 いっ た
見つかり ませ ん でした 	 みつかり ませ ん でした
消え行く 	 きえいく
撮り 続け た 	 とり つづけ た
読書 し 	 どくしょ し
まったりする 	 まったりする
癒し 	 いやし
感じ ます 	 かんじ ます
列し て 	 れつし て
入部 	 にゅうぶ
巻き込ま れ 	 まきこま れ
消滅 し た 	 しょうめつ し た
わかっ 	 わかっ
オープン 	 おーぷん
探究 し て 	 たんきゅう し て
要請 さ れ た 	 ようせい さ れ た
登壇 し た 	 とうだん し た
たたえ 	 たたえ
創設 	 そうせつ
届き ませ ん でした 	 とどき ませ ん でした
かけ られ た 	 かけ られ た
解く 	 とく
出版 し た 	 しゅっぱん し た
示唆 し 	 しさ し
置換 し て 	 ちかん し て
面し て 	 めんし て
鎮座 し 	 ちんざ し
飛来 し た 	 ひらい し た
輝 ける 	 てる ける
舞い込む 	 まいこむ
実現 し まし た 	 じつげん し まし た
退位 し た 	 たいい し た
在籍 し た 	 ざいせき し た
逃れ て 	 のがれ て
非難 する 	 ひなん する
転戦 し て 	 てんせん し て
対戦 	 たいせん
ブロー し なく て 	 ぶろー し なく て
スッキリ 	 すっきり
整え られる ように なり まし た 	 ととのえ られる ように なり まし た
患っ たら 	 わずらっ たら
診 て 	 み て
乗り たい 	 のり たい
執筆 	 しっぴつ
決まら ない 	 きまら ない
断ち切ろ う 	 たちきろ う
取ろ う 	 とろ う
もん だ 	 もん だ
こだわり 	 こだわり
下げ 	 さげ
届く 	 とどく
外 せ ない 	 はず せ ない
恐れ 	 おそれ
走り 	 はしり
期待 さ れ た 	 きたい さ れ た
安定 し た 	 あんてい し た
挙げ られ ず 	 あげ られ ず
登録 	 とうろく
決意 し 	 けつい し
渡っ た 	 わたっ た
突き刺し て 	 つきさし て
放出 する 	 ほうしゅつ する
読み込ま れ た 	 よみこま れ た
移動 できる 	 いどう できる
妥協 し て 	 だきょう し て
深め 	 ふかめ
築い て 	 きずい て
保障 さ れ て 	 ほしょう さ れ て
繋がり 	 つながり
分かり やすく て 	 わかり やすく て
楽になっ た 	 らくになっ た
結婚 し て 	 けっこん し て
恵まれる 	 めぐまれる
擬人化 する 	 ぎじんか する
大人び て 	 おとなび て
浸透 し て 	 しんとう し て
焼か れ た 	 やか れ た
食べ られ ます 	 たべ られ ます
根ざし た 	 ねざし た
活用 さ れる 	 かつよう さ れる
寄る 	 よる
上告 し て 	 じょうこく し て
こと でき ない 	 こと でき ない
関与 する 	 かんよ する
経由 し て 	 けいゆ し て
広める 	 ひろめる
協力 	 きょうりょく
みえる 	 みえる
紛れ込み 	 まぎれこみ
呼び ます 	 よび ます
出席 し て 	 しゅっせき し て
行ない 	 おこない
押し上げる 	 おしあげる
足る 	 あしる
持ち うる 	 もち うる
再現 でき ない 	 さいげん でき ない
訊い た 	 きい た
ふるえ 始め まし た 	 ふるえ はじめ まし た
入団 し た 	 にゅうだん し た
飛び出し 	 とびだし
励まし 	 はげまし
発車 し て 	 はっしゃ し て
変化 さ せ た 	 へんか さ せ た
逃げ 切っ て 	 にげ きっ て
企画 さ れ て 	 きかく さ れ て
優先 し て 	 ゆうせん し て
改編 さ れる 	 かいへん さ れる
昇格 し た 	 しょうかく し た
使え ない 	 つかえ ない
旅 し た 	 たび し た
締め 	 しめ
建造 さ れ 	 けんぞう さ れ
重視 し 	 じゅうし し
セッティング し やすい 	 せってぃんぐ し やすい
凌ぐ 	 りょうぐ
見 られ ます 	 み られ ます
創ら れ た 	 はじめら れ た
執っ た 	 とっ た
閉店 し て 	 へいてん し て
カウント し た 	 かうんと し た
持ち出し た 	 もちだし た
着か なかっ た 	 きか なかっ た
なら なかっ た 	 なら なかっ た
考えれ 	 かんがえれ
勧める ように 	 すすめる ように
出 直す 	 で なおす
選び まし た 	 えらび まし た
通じ ない 	 つうじ ない
齧っ て 	 かじっ て
目の当たりにし て 	 めのあたりにし て
揺さぶら れ て 	 ゆさぶら れ て
利用 し ませ ん 	 りよう し ませ ん
脱出 する 	 だっしゅつ する
抱き締め て 	 だきしめ て
生み出し た 	 うみだし た
始まり 	 はじまり
運び出す 	 はこびだす
撤去 する 	 てっきょ する
動き回る 	 うごきまわる
配属 さ れ て 	 はいぞく さ れ て
感じる ように なり 	 かんじる ように なり
確信 する 	 かくしん する
至り まし た 	 いたり まし た
慣れ て 	 なれ て
とれ まし た 	 とれ まし た
生産 し た 	 せいさん し た
裁判 	 さいばん
向い た 	 むい た
乗る 	 のる
取り付か れ 	 とりつか れ
終わる 	 おわる
対応 出来 ます 	 たいおう でき ます
準備 する 	 じゅんび する
聞かせ て 	 きかせ て
やめ ない 	 やめ ない
頑張ろ う 	 がんばろ う
扱い さ れ 	 あつかい さ れ
与え られ た 	 あたえ られ た
通告 し た 	 つうこく し た
題し て 	 だいし て
致し かね ます 	 いたし かね ます
問わ れ て 	 とわ れ て
選抜 さ れ た 	 せんばつ さ れ た
やら なかっ た 	 やら なかっ た
評 し て 	 ひょう し て
嘲笑 さ れ て 	 ちょうしょう さ れ て
賛成 し た 	 さんせい し た
プレー し た 	 ぷれー し た
開閉 さ せる 	 かいへい さ せる
任せ で 	 まかせ で
描か れる 	 えがか れる
すぐれ た 	 すぐれ た
あわせ 	 あわせ
すぐれ て 	 すぐれ て
転身 し た 	 てんしん し た
課さ れる 	 かさ れる
使え なく なり 	 つかえ なく なり
出来 なく なっ た 	 でき なく なっ た
就職 	 しゅうしょく
募集 し 	 ぼしゅう し
実行 さ れ た 	 じっこう さ れ た
生ん だ 	 うん だ
推薦 いたし ます 	 すいせん いたし ます
疑わ れ て 	 うたがわ れ て
呼ぶ べき 	 よぶ べき
怒ら ない 	 おこら ない
侵略 する 	 しんりゃく する
託さ れ て 	 たくさ れ て
径 て 	 けい て
デビュー する 	 でびゅー する
同意 し て 	 どうい し て
かなわ ない 	 かなわ ない
放映 さ れ た 	 ほうえい さ れ た
出入り し て 	 でいり し て
推測 さ れる 	 すいそく さ れる
匍匐 し 	 ほふく し
沿う 	 そう
永眠 する 	 えいみん する
旅行 し て 	 りょこう し て
言え ない 	 いえ ない
打 て ない 	 う て ない
包ま れ 	 つつま れ
くめ 	 くめ
戦っ た 	 せんっ た
申し ます 	 もうし ます
オープン さ せ て 	 おーぷん さ せ て
許さ ず 	 ゆるさ ず
刻ま れ た 	 きざま れ た
称さ れ て 	 しょうさ れ て
踏襲 し て 	 とうしゅう し て
呼ば れ 	 よば れ
乱立 し て 	 らんりつ し て
統一 す べく 	 とういつ す べく
策定 さ れ た 	 さくてい さ れ た
し たかっ た 	 し たかっ た
製作 し て 	 せいさく し て
書か ない 	 かか ない
調印 する 	 ちょういん する
拒否 し 	 きょひ し
引き上げ た 	 ひきあげ た
覆っ た 	 おおっ た
疑い まし た 	 うたがい まし た
解放 さ れ た 	 かいほう さ れ た
鎮圧 し た 	 ちんあつ し た
任命 さ れ た 	 にんめい さ れ た
称える 	 たたえる
勘違い さ れる 	 かんちがい さ れる
合成 し て 	 ごうせい し て
き 出す 	 き だす
楽にな れ ます 	 らくに なれ ます
フィードバック さ れる 	 ふぃーどばっく さ れる
同棲 し 	 どうせい し
身籠る 	 みごもる
入籍 し ない 	 にゅうせき し ない
やら ね 	 やら ね
施さ れ 	 ほどこさ れ
行 える ように なっ た 	 おこな える ように なっ た
否認 し た 	 ひにん し た
射殺 し た 	 しゃさつ し た
供述 し た 	 きょうじゅつ し た
起訴 し た 	 きそ し た
散っ て 	 ちっ て
プレー 出来 なかっ た 	 ぷれー でき なかっ た
叩か れ て 	 たたか れ て
舗装 し て 	 ほそう し て
くむ 	 くむ
ある みたい です 	 ある みたい です
転換 する 	 てんかん する
表示 する ように し たい 	 ひょうじ する ように し たい
募っ た 	 つのっ た
活用 し 	 かつよう し
連携 さ せる 	 れんけい さ せる
体験 出来 ない 	 たいけん でき ない
体験 し て 	 たいけん し て
継が せ て 	 つが せ て
溢れ た 	 あふれ た
顔 し て 	 かお し て
申し入れ まし た 	 もうしいれ まし た
開局 し た 	 かいきょく し た
返還 さ れ た 	 へんかん さ れ た
割り当て られ た 	 わりあて られ た
納車 さ れる 	 のうしゃ さ れる
だし て 	 だし て
転向 し た 	 てんこう し た
捉え 	 とらえ
判る 	 わかる
過ぎる 	 すぎる
のび 	 のび
呆れ させ て 	 あきれ させ て
殴ら れ た 	 なぐら れ た
改造 	 かいぞう
再生 し た 	 さいせい し た
信じ て 	 しんじ て
仕上がっ て 	 しあがっ て
与え ます 	 あたえ ます
受け なく なる 	 うけ なく なる
保た れ て 	 たもた れ て
次い 	 つい
利用 し よう 	 りよう し よう
頂い て 	 いただい て
酸化 し て 	 さんか し て
増殖 し て 	 ぞうしょく し て
撮 れ た 	 と れ た
リフレッシュ できる 	 りふれっしゅ できる
通っ 	 つうっ
連覇 し 	 れんぱ し
報い た 	 むくい た
投下 し 	 とうか し
視察 し た 	 しさつ し た
仕組ん だ 	 しくん だ
睨まれ た 	 にらまれ た
上演 	 じょうえん
飛ばさ れる ように なり 	 とばさ れる ように なり
わから なく なる 	 わから なく なる
援助 し よう 	 えんじょ し よう
鋳造 する 	 ちゅうぞう する
得 よう 	 え よう
加われ 	 くわわれ
避け られ ない 	 さけ られ ない
懸念 する 	 けねん する
会っ て 	 あっ て
食っ て 	 くっ て
食っ た 	 くっ た
思い出し て 	 おもいだし て
くぐる 	 くぐる
出塁 し た 	 しゅつるい し た
転倒 	 てんとう
進入 する 	 しんにゅう する
兼ね て 	 かね て
引き返し 	 ひきかえし
包囲 し 	 ほうい し
持ちこたえる 	 もちこたえる
届け られる 	 とどけ られる
立ち寄っ て 	 たちよっ て
移動 し 	 いどう し
確立 し た 	 かくりつ し た
築き 	 きずき
こうじ て 	 こうじ て
浮かん 	 うかん
受診 さ せ られ 	 じゅしん さ せ られ
やめ ざるをえ なかっ た 	 やめ ざるをえ なかっ た
審議 する 	 しんぎ する
定める 	 さだめる
送っ たら 	 おくっ たら
喜ぶ 	 よろこぶ
弱め て 	 よわめ て
相俟っ て 	 そうまつっ て
期待 し 得る 	 きたい し うる
義務付け られ て 	 ぎむづけ られ て
認め られ ない 	 みとめ られ ない
言っ たら 	 いっ たら
あふれ た 	 あふれ た
出迎え て 	 でむかえ て
あわせ た 	 あわせ た
まとまり 	 まとまり
出発 し 	 しゅっぱつ し
運行 さ れる 	 うんこう さ れる
応募 できる 	 おうぼ できる
応募 する 	 おうぼ する
反映 さ せる 	 はんえい さ せる
整理 さ れ 	 せいり さ れ
従事 し た 	 じゅうじ し た
役に立つ 	 やくにたつ
異なる ようだ 	 ことなる ようだ
面談 し た 	 めんだん し た
採用 でき ない 	 さいよう でき ない
見 られ 	 み られ
介入 する 	 かいにゅう する
即位 し た 	 そくい し た
擁立 し 	 ようりつ し
廃位 し て 	 はいい し て
開き 	 ひらき
反省 し 	 はんせい し
謝罪 し た 	 しゃざい し た
アップ さ れ て 	 あっぷ さ れ て
ご覧頂 け ます 	 ごらん いただけ ます
取得 する 	 しゅとく する
逃亡 	 とうぼう
意識 し 	 いしき し
行わ れ ます 	 おこなわ れ ます
拭い て 	 ふい て
目撃 し て 	 もくげき し て
おり 	 おり
回避 する 	 かいひ する
衰退 し 	 すいたい し
注文 し た 	 ちゅうもん し た
経過 し た 	 けいか し た
繰り出し て 	 くりだし て
発見 さ れ て 	 はっけん さ れ て
し た らしい 	 し た らしい
任命 し て 	 にんめい し て
閉会 し た 	 へいかい し た
確認 でき ます 	 かくにん でき ます
故障 し た 	 こしょう し た
建て られる 	 たて られる
捉える 	 とらえる
動員 さ れ た 	 どういん さ れ た
切ら せ て 	 きら せ て
策定 し 	 さくてい し
つなげ たい 	 つなげ たい
襲撃 	 しゅうげき
にぎわ せ て 	 にぎわ せ て
和ま せ なけれ 	 わま せ なけれ
魅かれ ます 	 ひかれ ます
発信 する 	 はっしん する
強化 し 	 きょうか し
掌握 し よう 	 しょうあく し よう
接触 する 	 せっしょく する
中断 さ れる 	 ちゅうだん さ れる
利用 し たい 	 りよう し たい
摘発 し ない 	 てきはつ し ない
契約 する 	 けいやく する
目撃 し た 	 もくげき し た
分かり ませ ん でした 	 わかり ませ ん でした
飲み すぎ て 	 のみ すぎ て
批判 し て 	 ひはん し て
訴え 続け て 	 うったえ つづけ て
闘っ て 	 たたかっ て
使わ せ て 	 つかわ せ て
依頼 し た 	 いらい し た
断ら れ た 	 ことわら れ た
作ら せ た 	 つくら せ た
なくなら ない 	 なくなら ない
生む 	 うむ
案じ て 	 あんじ て
利か ない 	 きか ない
周回 する 	 しゅうかい する
憩 える 	 けい える
ぬっ て 	 ぬっ て
矯正 し て 	 きょうせい し て
提出 する 	 ていしゅつ する
考案 さ れ 	 こうあん さ れ
用い られ て 	 もちい られ て
浴び て 	 あび て
守ろ う 	 まもろ う
そろっ て 	 そろっ て
採用 さ れ まし た 	 さいよう さ れ まし た
攻略 し 	 こうりゃく し
交戦 し た 	 こうせん し た
包囲 し て 	 ほうい し て
よぶ 	 よぶ
扱う べき 	 あつかう べき
想い 	 おもい
出 	 で
過ご せる 	 すご せる
独立 し 	 どくりつ し
勝ち進ん だ 	 かちすすん だ
切る 	 きる
折り し 	 おり し
揺れる 	 ゆれる
待ち望ん 	 まちのぞん
欠かさ ない 	 かかさ ない
列挙 する 	 れっきょ する
犯す 	 おかす
信用 し たい 	 しんよう し たい
疑っ て 	 うたがっ て
値上げ し た みたい 	 ねあげ し た みたい
前借り する 	 まえがり する
呼び寄せる 	 よびよせる
譲っ て 	 ゆずっ て
手に入れる 	 てにいれる
乗っ た 	 のっ た
忘れ られ ない 	 わすれ られ ない
薦め たい 	 すすめ たい
被せ られ た 	 かぶせ られ た
経験 する 	 けいけん する
拘束 さ れ て 	 こうそく さ れ て
遅れる 	 おくれる
山積み 	 やまづみ
行き たく ない 	 いき たく ない
乗り越え て 	 のりこえ て
就職 し た 	 しゅうしょく し た
従軍 し た 	 じゅうぐん し た
落ちる 	 おちる
読める 	 よめる
凝らし 	 こらし
惹か れ 	 ひか れ
望む ように なる 	 のぞむ ように なる
在籍 	 ざいせき
つ け た 	 つ け た
払い 	 ばらい
落とし た 	 おとし た
な れ そう です 	 な れ そう です
備え た 	 そなえ た
発進 できる ように 	 はっしん できる ように
発注 し た 	 はっちゅう し た
施行 さ れ て 	 しこう さ れ て
握 れ て 	 にぎ れ て
喪失 さ せる 	 そうしつ さ せる
監督 さ れ た 	 かんとく さ れ た
推定 さ れ て 	 すいてい さ れ て
はね られ た 	 はね られ た
引きずら れ た 	 ひきずら れ た
返さ れる 	 かえさ れる
読み取る 	 よみとる
入力 し て 	 にゅうりょく し て
絶っ た 	 たっ た
成り済まし 	 なりすまし
徴収 さ れ た 	 ちょうしゅう さ れ た
復活 さ れ た 	 ふっかつ さ れ た
設定 さ れ 	 せってい さ れ
積ま れ た 	 つま れ た
み たい 	 み たい
展開 さ れ て 	 てんかい さ れ て
はぜ ん 	 はぜ ん
貢献 	 こうけん
笑わせ よう 	 わらわせ よう
断りし た 	 ことわりし た
共演 し た 	 きょうえん し た
解体 	 かいたい
締め括ら れる 	 しめくくら れる
支払い 	 しはらい
釈放 	 しゃくほう
選ば れ た 	 えらば れ た
手がける 	 てがける
弱まり 	 よわまり
育て られ 	 そだて られ
自作 し て 	 じさく し て
作り上げる 	 つくりあげる
でき なかっ た ような 	 でき なかっ た ような
区分 さ れ て 	 くぶん さ れ て
許諾 し た 	 きょだく し た
撮影 でき まし た 	 さつえい でき まし た
特攻 する 	 とっこう する
留学 	 りゅうがく
売り 	 うり
持ち帰っ た 	 もちかえっ た
面会 し 	 めんかい し
発する 	 はつする
侵攻 し た 	 しんこう し た
追放 さ れ 	 ついほう さ れ
没収 さ れ た 	 ぼっしゅう さ れ た
献金 する 	 けんきん する
いぶかる 	 いぶかる
縦断 する 	 じゅうだん する
判断 	 はんだん
低下 し た 	 ていか し た
指揮 し た 	 しき し た
みとめ られる 	 みとめ られる
逃がす 	 にがす
立ち塞がっ た 	 たちふさがっ た
感得 し た 	 かんとく し た
思わ せる ような 	 おもわ せる ような
漂っ て 	 ただよっ て
説明 し ます 	 せつめい し ます
培っ て 	 つちかっ て
入場 できる 	 にゅうじょう できる
加入 する 	 かにゅう する
警戒 さ れ て 	 けいかい さ れ て
搭載 さ れる 	 とうさい さ れる
確保 する 	 かくほ する
呪い 	 のろい
予言 する 	 よげん する
歌っ て 	 うたっ て
保有 し て 	 ほゆう し て
密着 し た 	 みっちゃく し た
みせ て 	 みせ て
扱い する 	 あつかい する
投稿 し た 	 とうこう し た
模倣 さ れ て 	 もほう さ れ て
引き上げ て 	 ひきあげ て
改め られ た 	 あらため られ た
変わら なかっ た 	 かわら なかっ た
もて まし た 	 もて まし た
挑戦 できる 	 ちょうせん できる
怖れ 	 おそれ
すっ 	 すっ
叩き 	 たたき
うかがう 	 うかがう
検索 さ れる 	 けんさく さ れる
言わ れ ます 	 いわ れ ます
納まる 	 おさまる
顔見知り 	 かおみしり
落下 	 らっか
襲っ た 	 おそっ た
行き 直し て 	 い きなおし て
積み 	 つみ
葬り 	 ほうむり
隆起 し て 	 りゅうき し て
なっ た らしい 	 なっ た らしい
流入 し て 	 りゅうにゅう し て
抜く 	 ぬく
抜け 出し 	 ぬけ だし
差し切っ て 	 さしきっ て
あげ た 	 あげ た
チャレンジ し た 	 ちゃれんじ し た
実現 し たら 	 じつげん し たら
管理 さ せる 	 かんり さ せる
送り 	 おくり
催促 し まし た 	 さいそく し まし た
重ね 合う 	 かさ ねあう
追いつか れ 	 おいつか れ
繋い 	 つない
起始 し 	 おきし し
抱き こむ ように 	 だき こむ ように
走っ て 	 はしっ て
広がっ て 	 ひろがっ て
パワーアップ する 	 ぱわーあっぷ する
聴こえる 	 きこえる
激化 し ます 	 げきか し ます
沈静化 し た 	 ちんせいか し た
取り付け て 	 とりつけ て
探っ て 	 さぐっ て
告げ ましょ う 	 つげ ましょ う
敬愛 し 	 けいあい し
構え て 	 かまえ て
撤回 さ せ て 	 てっかい さ せ て
強め て 	 つよめ て
取立て 	 とりたて
直訴 し た 	 じきそ し た
潰さ れ た 	 つぶさ れ た
留まら なかっ た 	 とまら なかっ た
提供 し た 	 ていきょう し た
感じ れ まし た 	 かんじ れ まし た
届け られ た 	 とどけ られ た
削っ た 	 けずっ た
下がり まし た 	 さがり まし た
到着 し 	 とうちゃく し
表明 し 	 ひょうめい し
さしあたっ て 	 さしあたっ て
信用 する 	 しんよう する
擁し 	 ようし
優勝 する 	 ゆうしょう する
い なけれ 	 い なけれ
達成 でき ない 	 たっせい でき ない
購入 	 こうにゅう
消費 さ れ た 	 しょうひ さ れ た
計る 	 けいる
再選 さ れ た 	 さいせん さ れ た
比べ たら 	 くらべ たら
噛む 	 かむ
結び付け て 	 むすびつけ て
解釈 し て 	 かいしゃく し て
救っ た 	 すくっ た
受賞 さ れる 	 じゅしょう さ れる
辞退 し た 	 じたい し た
異なり ます 	 ことなり ます
干し て 	 ほし て
予定 	 よてい
癒さ れ ます 	 いやさ れ ます
打ち上げ られ 	 うちあげ られ
招聘 さ れ て 	 しょうへい さ れ て
着任 	 ちゃくにん
性交 する だろ う 	 せいこう する だろ う
勧誘 でき ない 	 かんゆう でき ない
脱会 し た よう です 	 だっかい し た よう です
くる 	 くる
催さ ん 	 もよお さん
翻訳 し た 	 ほんやく し た
辞める 	 やめる
達成 し て 	 たっせい し て
出資 し た 	 しゅっし し た
触れ られ て 	 ふれ られ て
かかわっ た 	 かかわっ た
とろ う 	 とろ う
授かろ う 	 さずかろ う
購入 出来 なかっ た 	 こうにゅう でき なかっ た
付け 	 つけ
直ら なかっ た 	 なおら なかっ た
増え まし た 	 ふえ まし た
組 まさ れ 	 く まさ れ
与え られ ない 	 あたえ られ ない
引き締め 	 ひきしめ
請求 する ような 	 せいきゅう する ような
とら ず 	 とら ず
挑発 する 	 ちょうはつ する
進軍 	 しんぐん
布告 し た 	 ふこく し た
連想 する 	 れんそう する
統治 し た 	 とうち し た
踏襲 する 	 とうしゅう する
編纂 し た 	 へんさん し た
当て た 	 あて た
喜ば れ まし た 	 よろこば れ まし た
貸し付け られ て 	 かしつけ られ て
追及 する 	 ついきゅう する
奪 え なかっ た 	 うば え なかっ た
防御 し た 	 ぼうぎょ し た
入館 する 	 にゅうかん する
入れ ます 	 いれ ます
みなす 	 みなす
倹約 し て 	 けんやく し て
説明 し 	 せつめい し
頑張っ たら 	 がんばっ たら
暴か れる 	 あばか れる
使わ なく て 	 つかわ なく て
すむ ように 	 すむ ように
考慮 さ れ て 	 こうりょ さ れ て
設計 さ れ て 	 せっけい さ れ て
自己主張 し 	 じこしゅちょう し
手術 	 しゅじゅつ
壊れ て 	 こわれ て
戸惑う 	 とまどう
喘ぐ 	 あえぐ
かまわ ない 	 かまわ ない
注目 さ れる 	 ちゅうもく さ れる
倒さ なく て 	 たおさ なく て
腫れ上がっ 	 はれあがっ
入団 し 	 にゅうだん し
マッチ し ない 	 まっち し ない
パンク し ない 	 ぱんく し ない
替え て 	 かえ て
見上げ 	 みあげ
ぶら下がっ 	 ぶらさがっ
動く 様に 	 うごく ように
はせ て 	 はせ て
むき出し て 	 むきだし て
笑っ て 	 わらっ て
かぶっ た 	 かぶっ た
問い質し た そうだ 	 といただし た そうだ
受け流し た ようだ 	 うけながし た ようだ
意義付け さ れ 	 いぎづけ さ れ
公表 せ ず 	 こうひょう せ ず
待っ た そうです 	 まっ た そうです
満足 でき ます 	 まんぞく でき ます
できる かもしれ ない 	 できる かもしれ ない
い た ように 	 い た ように
見え まし た 	 みえ まし た
利用 出来る 	 りよう できる
はまっ て 	 はまっ て
ドキドキ し ます 	 どきどき し ます
生中継 し た 	 なまちゅうけい し た
寄付 する 	 きふ する
安定 し て 	 あんてい し て
発言 する 	 はつげん する
灼か れ て 	 しゃくか れ て
受け なかっ た 	 うけ なかっ た
採り 	 とり
告げ て 	 つげ て
輸入 さ れ た 	 ゆにゅう さ れ た
充て まし た 	 あて まし た
覚え た 	 おぼえ た
汲ん 	 くみん
広げる 	 ひろげる
下さい 	 ください
ずば抜け て 	 ずばぬけ て
優れる 	 すぐれる
脱し 	 だっし
はさん 	 はさん
解禁 さ れ て 	 かいきん さ れ て
編成 さ れ て 	 へんせい さ れ て
閉鎖 し て 	 へいさ し て
命名 さ れ て 	 めいめい さ れ て
受注 し た 	 じゅちゅう し た
回避 し 	 かいひ し
浮上 	 ふじょう
承認 し て 	 しょうにん し て
抜け た 	 ぬけ た
結集 さ せ た 	 けっしゅう さ せ た
推し 	 すいし
生産 さ れ なかっ た 	 せいさん さ れ なかっ た
受け付け ない 	 うけつけ ない
運び 	 はこび
搭載 	 とうさい
売り出さ れる 	 うりださ れる
売却 する 	 ばいきゃく する
いやさ れ まし た 	 いやさ れ まし た
確立 し 	 かくりつ し
転用 さ れ 	 てんよう さ れ
荒らす 	 あらす
煮やし 	 にやし
返す 	 かえす
返し て 	 かえし て
貰っ て 	 もらっ て
移り まし た 	 うつり まし た
写っ た 	 うつっ た
憑い て 	 うつい て
写し出し て 	 うつしだし て
宿泊 し ます 	 しゅくはく し ます
期待 し て 	 きたい し て
護送 さ れ 	 ごそう さ れ
接触 し 	 せっしょく し
切り取ら れ て 	 きりとら れ て
圧縮 でき ない ような 	 あっしゅく でき ない ような
通え 	 かよえ
証言 し まし た 	 しょうげん し まし た
関知 し て 	 かんち し て
受け付ける 	 うけつける
楽しみ です 	 たのしみ です
集中 	 しゅうちゅう
復帰 	 ふっき
打ち込む ように なっ た 	 うちこむ ように なっ た
乗り換え 	 のりかえ
組み立て た 	 くみたて た
度重なる 	 たびかさなる
振っ た 	 ふっ た
輝い た 	 かがやい た
口走る 	 くちばしる
言わ ざるを得 ませ ん 	 いわ ざるをえ ませ ん
追贈 さ れ 	 ついぞう さ れ
建て られ た 	 たて られ た
加盟 	 かめい
付け られる 	 つけ られる
解散 し た 	 かいさん し た
繰り広げ て 	 くりひろげ て
加入 し 	 かにゅう し
敗訴 	 はいそ
瞬殺 し た 	 またたきころ し た
注意 し て 	 ちゅうい し て
渡し 	 わたし
謝罪 	 しゃざい
ふまえ て 	 ふまえ て
デザイン し て 	 でざいん し て
工夫 さ れ て 	 くふう さ れ て
悩ん 	 なやん
披露 し て 	 ひろう し て
アクセス し た 	 あくせす し た
アクセス し て 	 あくせす し て
模し て 	 もし て
行なわ れ 	 おこなわ れ
かわる 	 かわる
求め られ 	 もとめ られ
導入 さ れ た 	 どうにゅう さ れ た
結成 さ れ 	 けっせい さ れ
節約 し たい 	 せつやく し たい
発散 する 	 はっさん する
篭る 	 こもる
名付け た 	 なづけ た
帰ら ない 	 かえら ない
可愛がら れ て 	 かわいがら れ て
偏っ て 	 かたよっ て
もてはやさ れ まし た 	 もてはやさ れ まし た
勧める 	 すすめる
配 れる 	 くば れる
総合 	 そうごう
驚い 	 おどろい
嫌がっ 	 いやがっ
ほめ て 	 ほめ て
わくわくし た 	 わくわくし た
引き立て て 	 ひきたて て
要望 し た 	 ようぼう し た
過ぎ て 	 すぎ て
推進 し 	 すいしん し
受け ます 	 うけ ます
刻む 	 きざむ
担わ せる 	 になわ せる
変更 し 	 へんこう し
配置 すれ 	 はいち すれ
配置 できる 	 はいち できる
節約 できる 	 せつやく できる
あわせ て 	 あわせ て
伴わ れ て 	 ともなわ れ て
なし た 	 なし た
埋め立て られ て 	 うめたて られ て
歩き やすい 	 あるき やすい
執筆 し て 	 しっぴつ し て
呼ば れ なかっ た 	 よば れ なかっ た
認定 さ れ た 	 にんてい さ れ た
運用 さ れ た 	 うんよう さ れ た
オープン し 	 おーぷん し
行わ れる ように なっ た 	 おこなわ れる ように なっ た
引越 し て 	 ひっこし し て
曲げ 	 まげ
くねら せ て 	 くねら せ て
表現 し て 	 ひょうげん し て
ご覧ください 	 ごらんください
敗退 	 はいたい
行け ない 	 いけ ない
致し まし た 	 いたし まし た
保っ て 	 たもっ て
伝え られ ず 	 つたえ られ ず
困っ て 	 こまっ て
作曲 し て 	 さっきょく し て
解放 さ れ 	 かいほう さ れ
成熟 し た 	 せいじゅく し た
認め られ た 	 みとめ られ た
込め て 	 こめ て
食べ た 	 たべ た
もらい 	 もらい
掲げ て 	 かかげ て
惹きつけ 	 ひきつけ
応戦 	 おうせん
勝 て た 	 か て た
改称 さ れ 	 かいしょう さ れ
多用 し た 	 たよう し た
分断 さ れ て 	 ぶんだん さ れ て
埋め られ た 	 うめ られ た
起用 し 	 きよう し
のたまっ て 	 のたまっ て
急落 し た 	 きゅうらく し た
増員 さ れ た 	 ぞういん さ れ た
脱退 し て 	 だったい し て
降っ て 	 ふっ て
濡れ て 	 ぬれ て
無くなり 	 なくなり
帰郷 する 	 ききょう する
打ち上げ 	 うちあげ
振動 し た 	 しんどう し た
みなさ れ た 	 みなさ れ た
殴り 	 なぐり
営ん 	 いとなん
仕切る 	 しきる
ウケる 	 うける
立ち寄る 	 たちよる
移設 し て 	 いせつ し て
い なく なる 	 い なく なる
列挙 できる 	 れっきょ できる
装備 し て 	 そうび し て
帰国 し 	 きこく し
就任 し 	 しゅうにん し
先発 	 せんぱつ
投げ 	 なげ
冷遇 さ れ て 	 れいぐう さ れ て
前進 し 	 ぜんしん し
率い 	 ひきい
跋扈 する 	 ばっこ する
送ら れ 	 おくら れ
育て られる 	 そだて られる
発見 	 はっけん
阻ま れ て 	 はばま れ て
空爆 さ れ た 	 くうばく さ れ た
許可 さ れ た 	 きょか さ れ た
採用 さ れ 	 さいよう さ れ
聴き 	 きき
懐かしむ ように 	 なつかしむ ように
ぶり 	 ぶり
かない まし た 	 かない まし た
脱会 し て 	 だっかい し て
否定 し て 	 ひてい し て
辞め て 	 やめ て
解読 さ れ た 	 かいどく さ れ た
推す 	 おす
食せ ます 	 しょくせ ます
し 続け て 	 し つづけ て
当たら ない 	 あたら ない
記し た 	 きし た
受け容れ られ なかっ た 	 うけいれ られ なかっ た
流れ ない 	 ながれ ない
該当 し て 	 がいとう し て
再訪 し た 	 さいほう し た
起動 し 	 きどう し
敗北 し 	 はいぼく し
封じ られ 	 ふうじ られ
果たす べく 	 はたす べく
送り 続け て 	 おくり つづけ て
遠慮 し た 	 えんりょ し た
提出 さ れ た 	 ていしゅつ さ れ た
からま れ て 	 からま れ て
酸化 し た 	 さんか し た
逸脱 し 過ぎ て 	 いつだつ し すぎ て
応援 し 	 おうえん し
手渡 し た 	 てわた し た
販売 でき なく なっ た 	 はんばい でき なく なっ た
行き詰まり 	 いきづまり
退任 	 たいにん
所属 さ せ られ て 	 しょぞく さ せ られ て
直結 し て 	 ちょっけつ し て
とる 	 とる
実践 し て 	 じっせん し て
広げ て 	 ひろげ て
倒れる 	 たおれる
削除 する 	 さくじょ する
改善 し まし た 	 かいぜん し まし た
壊れ 始め 	 こわれ はじめ
見 られ ず 	 み られ ず
接さ れ て 	 せっさ れ て
使い づめる 	 つかい づめる
消化 し た 	 しょうか し た
体現 し た 	 たいげん し た
解決 し 	 かいけつ し
確約 さ れ た 	 かくやく さ れ た
切り離し 	 きりはなし
動作 さ せる 	 どうさ さ せる
佩用 し て 	 はいよう し て
複合 し ない 	 ふくごう し ない
入り浸っ て 	 いりびたっ て
探せ 	 さがせ
びびら ず 	 びびら ず
話しかける 	 はなしかける
送ら れる 	 おくら れる
踏み出す 	 ふみだす
出店 する 	 しゅってん する
わかり まし た 	 わかり まし た
ある でしょ う 	 ある でしょ う
主張 し た 	 しゅちょう し た
見 込 める 	 み こ める
見極め た 	 みきわめ た
増やし たい 	 ふやし たい
はずす 	 はずす
控える 	 ひかえる
張っ た 	 はっ た
強化 さ れる 	 きょうか さ れる
突入 し 	 とつにゅう し
負傷 	 ふしょう
着く 	 つく
乗車 できる 	 じょうしゃ できる
眺め られる 	 ながめ られる
奪わ れ た 	 うばわ れ た
控え て 	 ひかえ て
すり替え て 	 すりかえ て
過密化 し た 	 かみつか し た
参列 し て 	 さんれつ し て
数える 	 かぞえる
選定 	 せんてい
対面 し た 	 たいめん し た
増え ます 	 ふえ ます
残り まし た 	 のこり まし た
先制 し た 	 せんせい し た
狙わ れ た 	 ねらわ れ た
飲 め ます 	 の め ます
出航 し 	 しゅっこう し
退役 	 たいえき
保管 さ れ た 	 ほかん さ れ た
合体 し なかっ た 	 がったい し なかっ た
阻害 し て 	 そがい し て
批判 さ れ た 	 ひはん さ れ た
重宝 し て 	 ちょうほう し て
受け継い 	 うけつい
恐れ た 	 おそれ た
ほのめかし た 	 ほのめかし た
やら ない そうだ 	 やら ない そうだ
借り 切っ て 	 かり きっ て
絶やさ ない 	 たやさ ない
指導 し て 	 しどう し て
分離 し た 	 ぶんり し た
独占 し やすい 	 どくせん し やすい
くぐり 	 くぐり
下りる 	 おりる
下げ られ た そうです 	 さげ られ た そうです
泊まり 	 とまり
カリカリ 	 かりかり
散見 さ れる 	 さんけん さ れる
計数 し 	 けいすう し
和解 し た 	 わかい し た
操縦 し 	 そうじゅう し
繰り広げ られ た 	 くりひろげ られ た
備え られ た 	 そなえ られ た
君臨 し て 	 くんりん し て
運航 する 	 うんこう する
昇格 し 	 しょうかく し
確認 さ れ た 	 かくにん さ れ た
更新 さ れる 	 こうしん さ れる
開業 する 	 かいぎょう する
栽培 できる 	 さいばい できる
会見 し 	 かいけん し
拘束 	 こうそく
運行 さ れる ように なっ て 	 うんこう さ れる ように なっ て
惹きつける 	 ひきつける
患い 	 かんい
改装 さ れ た 	 かいそう さ れ た
活用 さ れ た 	 かつよう さ れ た
反抗 する 	 はんこう する
亘る 	 わたる
取り組み 	 とりくみ
落ち着き ます 	 おちつき ます
アドバイス する 	 あどばいす する
通行 する 	 つうこう する
撃た れ て 	 うた れ て
説明 さ れる 	 せつめい さ れる
運航 し て 	 うんこう し て
紹介 出来る 	 しょうかい できる
隣り 	 となり
隣接 し た 	 りんせつ し た
共謀 し て 	 きょうぼう し て
こさ ん 	 こさ ん
貶める 	 おとしめる
返せ 	 かえせ
解決 でき ない 	 かいけつ でき ない
募り 	 ぼり
特定 さ れ て 	 とくてい さ れ て
学ば ない 	 まなば ない
助かっ て 	 たすかっ て
戻さ れ て 	 もどさ れ て
接ぎ 	 はぎ
懇願 し 	 こんがん し
一目置か れる 	 いちもくおか れる
指導 さ れる 	 しどう さ れる
敵対 し て 	 てきたい し て
ふるまい 	 ふるまい
維持 し よう 	 いじ し よう
体験 でき ます 	 たいけん でき ます
増え た 	 ふえ た
刺さっ た 	 ささっ た
もみ 	 もみ
ほぐし て 	 ほぐし て
ゲット し て 	 げっと し て
下落 し た 	 げらく し た
脱会 	 だっかい
そびえる 	 そびえる
刻み 込ま れ て 	 きざ みこま れ て
はっきりし ない 	 はっきりし ない
就航 さ せ た 	 しゅうこう さ せ た
停止 し て 	 ていし し て
避難 さ せる 	 ひなん さ せる
発揮 し て 	 はっき し て
あたっ た 	 あたっ た
願う 	 ねがう
合格 する 	 ごうかく する
判断 でき た 	 はんだん でき た
のぞけ 	 のぞけ
公開 さ れ 	 こうかい さ れ
驚嘆 する 	 きょうたん する
かみ 合う 	 かみ あう
重なり合わ ない ように 	 かさなりあわ ない ように
工夫 し て 	 くふう し て
分け られ て 	 わけ られ て
申し合わせ 	 もうしあわせ
逮捕 	 たいほ
書類送検 し 	 しょるいそうけん し
切り出し た 	 きりだし た
逃げ られ ない 	 にげ られ ない
作り上げ 	 つくりあげ
演じ て 	 えんじ て
途切れ ず 	 とぎれ ず
さておき 	 さておき
描写 さ れ て 	 びょうしゃ さ れ て
殺害 さ れる 	 さつがい さ れる
控え た 	 ひかえ た
減税 する 	 げんぜい する
紛れ て 	 まぎれ て
見当たら ない 	 みあたら ない
否定 さ れ て 	 ひてい さ れ て
働か せる 	 はたらか せる
囲ま れる 	 かこま れる
買い取っ て 	 かいとっ て
兼任 	 けんにん
話さ なかっ た 	 はなさ なかっ た
失わ れ 	 うしなわ れ
依頼 し て 	 いらい し て
拭う 	 ぬぐう
除し た 	 のぞし た
博し て 	 ひろしし て
踊っ た 	 おどっ た
就い た 	 つい た
上下 さ せる 	 じょうげ さ せる
チャーター し なきゃ なら なく て 	 ちゃーたー し なきゃ なら なく て
かさん 	 かさん
とどまり ませ ん 	 とどまり ませ ん
争 え ない 	 あらそ え ない
求め でき ます 	 もとめ でき ます
追い求める 	 おいもとめる
深まる 	 ふかまる
把握 できる 	 はあく できる
いう らしい 	 いう らしい
き たら 	 き たら
泊まっ て 	 とまっ て
通信 する 	 つうしん する
混み合う 	 こみあう
し ない そうです 	 し ない そうです
云う ような 	 いう ような
見聞き する 	 みきき する
払っ た 	 はらっ た
思わ れ がち です 	 おもわ れ がち です
建設 	 けんせつ
試み た 	 こころみ た
入院 	 にゅういん
し こま せ 	 し こま せ
増やせ 	 ふやせ
当選 できる だろ う 	 とうせん できる だろ う
訴え させ た 	 うったえ させ た
注入 さ れ た 	 ちゅうにゅう さ れ た
使い切る 	 つかいきる
断行 し て 	 だんこう し て
計上 し 	 けいじょう し
撃破 し 	 げきは し
強化 し て 	 きょうか し て
上映 さ れ た 	 じょうえい さ れ た
据え 	 すえ
稼動 し て 	 かどう し て
間に合わ ない 	 まにあわ ない
見せ 	 みせ
治療 し て 	 ちりょう し て
場所柄 し 	 ばしょがら し
憮然とし た 	 ぶぜんとし た
補佐 する 	 ほさ する
創設 し 	 そうせつ し
表記 し た 	 ひょうき し た
出土 し て 	 しゅつど し て
利用 し ます 	 りよう し ます
分節 さ れ た 	 ぶんせつ さ れ た
払え 	 はらえ
遭い 	 あい
任命 	 にんめい
反省 する 	 はんせい する
切り抜ける 	 きりぬける
活用 し て 	 かつよう し て
おしえ て 	 おしえ て
コメント し まし た 	 こめんと し まし た
嫌がる 	 いやがる
労働 し 	 ろうどう し
達成 さ れ た 	 たっせい さ れ た
再生 する 	 さいせい する
描写 する 	 びょうしゃ する
知らせ 	 しらせ
知らせる 	 しらせる
向き合う ように なる 	 むきあう ように なる
なり たく ない 	 なり たく ない
勃発 し て 	 ぼっぱつ し て
刊行 	 かんこう
勧め られ て 	 すすめ られ て
だまさ れ て 	 だまさ れ て
打ち込む 	 うちこむ
生存 し て 	 せいぞん し て
取り消さ れ ない 	 とりけさ れ ない
取り消さ れ なかっ た 	 とりけさ れ なかっ た
購入 でき ます 	 こうにゅう でき ます
イメージ さ せる 	 いめーじ さ せる
つとめる 	 つとめる
封印 さ れ て 	 ふういん さ れ て
訪問 し 	 ほうもん し
あっ た よう です 	 あっ た よう です
興じる ように なり 	 きょうじる ように なり
取り戻し 始め た 	 とりもどし はじめ た
さび させ 	 さび させ
提唱 	 ていしょう
発し た 	 はつし た
回る 	 まわる
あっ た ように 	 あっ た ように
顕彰 する 	 けんしょう する
集計 し て 	 しゅうけい し て
障害 し 	 しょうがい し
支持 する よう 	 しじ する よう
要請 	 ようせい
録音 さ れ 	 ろくおん さ れ
出 なく て 	 で なく て
出 ます 	 で ます
みたさ ない 	 みたさ ない
出現 せ ず 	 しゅつげん せ ず
貯め られる 	 ため られる
怖がり 	 こわがり
聞い 	 きい
上げる 	 あげる
出れ 	 でれ
出 られる 	 で られる
上京 し 	 じょうきょう し
携わる 	 たずさわる
送付 し て 	 そうふ し て
示さ れ て 	 しめさ れ て
留保 する 	 りゅうほ する
深め て 	 ふかめ て
除籍 する 	 じょせき する
一致 	 いっち
裏切っ て 	 うらぎっ て
発動 さ れる 	 はつどう さ れる
射殺 し 	 いころ し
迫っ て 	 せまっ て
出 させ 	 だ させ
回復 さ せ た 	 かいふく さ せ た
打ち立て た 	 うちたて た
買え 	 かえ
棄却 する 	 ききゃく する
言い渡し 	 いいわたし
敗訴 し まし た 	 はいそ し まし た
嫁ぎ 	 よめぎ
産ん 	 うん
上がっ ちゃい まし た 	 あがっ ちゃい まし た
制作 し て 	 せいさく し て
提出 し 	 ていしゅつ し
受理 さ れ まし た 	 じゅり さ れ まし た
把握 する 	 はあく する
繙き 	 ひもとき
分析 する 	 ぶんせき する
集め 合わ せ て 	 あつめ あわ せ て
探し だし た 	 さがし だし た
いがみ合う 	 いがみあう
立つ 	 たつ
出 せ ない 	 だ せ ない
北進 し 	 ほくしん し
統合 	 とうごう
やり 込む 	 やり こむ
試作 さ れ た 	 しさく さ れ た
配信 さ れ なかっ た 	 はいしん さ れ なかっ た
購入 し まし た 	 こうにゅう し まし た
組み立て られ た 	 くみたて られ た
了承 し て 	 りょうしょう し て
逃げ 出し た 	 にげ だし た
手に入れ たい 	 てにいれ たい
組み合わせ し て 	 くみあわせ し て
加速 する だろ う 	 かそく する だろ う
終え なければ なら ない 	 おえ なければ なら ない
行き着き まし た 	 いきつき まし た
行なわ れ て 	 おこなわ れ て
処刑 さ れ た 	 しょけい さ れ た
広まっ て 	 ひろまっ て
報告 さ れる 	 ほうこく さ れる
落ち込む 	 おちこむ
飲み たく て 	 のみ たく て
ござい まし た 	 ござい まし た
執ら れ た 	 とら れ た
就き 	 なりき
貰い たい 	 もらい たい
カバー する 	 かばー する
カバー し て 	 かばー し て
ます 	 ます
追い込ま れ て 	 おいこま れ て
もた ない 	 もた ない
問い詰め た 	 といつめ た
認め まし た 	 みとめ まし た
通り越し て 	 とおりこし て
呆れ た 	 あきれ た
宿泊 し まし た 	 しゅくはく し まし た
突破 でき なかっ た 	 とっぱ でき なかっ た
指揮 	 しき
保存 し て 	 ほぞん し て
貸し た 	 かし た
見 られ て 	 み られ て
透け 始める 	 すけ はじめる
暮らす べき だ 	 くらす べき だ
遣わし て 	 つかわし て
表面化 し た 	 ひょうめんか し た
調理 さ れ て 	 ちょうり さ れ て
家宅捜索 する 	 かたくそうさく する
喰らっ て 	 くらっ て
活性化 	 かっせいか
質問 し た 	 しつもん し た
質問 し ない 	 しつもん し ない
記入 さ れ て 	 きにゅう さ れ て
結婚 	 けっこん
招き かね ない 	 まねき かね ない
謳っ て 	 うたっ て
タイプ し た 	 たいぷ し た
伝え なかっ た 	 つたえ なかっ た
鳴らす べく 	 ならす べく
呼びし て 	 よびし て
劣化 し た 	 れっか し た
さび 	 さび
収録 し た 	 しゅうろく し た
大別 し 	 たいべつ し
交差 する 	 こうさ する
振る舞い 	 ふるまい
育っ た 	 そだっ た
言い立て て 	 いいたて て
げんなりさ せ た 	 げんなりさ せ た
投入 する 	 とうにゅう する
取り仕切っ て 	 とりしきっ て
話し合う 	 はなしあう
断り 	 ことわり
同席 し て 	 どうせき し て
手渡 さ れ た 	 てわた さ れ た
行き来 する 	 いきき する
寝 て 	 ね て
配属 さ れる 	 はいぞく さ れる
選ば ない 	 えらば ない
注文 でき ませ ん 	 ちゅうもん でき ませ ん
削っ て 	 けずっ て
否定 する 	 ひてい する
しゃべる 	 しゃべる
あまり 出来 ない 	 あまり でき ない
入居 し て 	 にゅうきょ し て
乗務 する 	 じょうむ する
乗務 し 	 じょうむ し
頂き ます 	 いただき ます
分類 できる 	 ぶんるい できる
捕らわれ た 	 とらわれ た
依頼 し 	 いらい し
罹っ て 	 かかっ て
焼失 	 しょうしつ
増大 さ せ た 	 ぞうだい さ せ た
担当 し 	 たんとう し
告示 さ れ 	 こくじ さ れ
受理 し た 	 じゅり し た
なさ れる 	 なさ れる
開催 し ない 	 かいさい し ない
書き込み し て 	 かきこみ し て
呼ぶ よう 	 よぶ よう
締め付け て 	 しめつけ て
反抗 し たい 	 はんこう し たい
創立 さ れ た 	 そうりつ さ れ た
解説 し た 	 かいせつ し た
論じ て 	 ろんじ て
追徴課税 し た 	 ついちょうかぜい し た
応じ 	 おうじ
見て取 れる 	 みて とれる
配る で 	 くばる で
聴き入っ て 	 ききいっ て
装う 	 よそおう
聞 け て 	 き け て
躓く 	 つまずく
曳き 	 ひき
ぶつけ 合い 	 ぶつけ あい
捉え にくい 	 とらえ にくい
なり にくい 	 なり にくい
流行 する 	 りゅうこう する
相談 し にくく 	 そうだん し にくく
相談 し 	 そうだん し
通過 し ます 	 つうか し ます
利用 でき ます 	 りよう でき ます
詠わ れ て 	 よわ れ て
被り 	 かぶり
塗り 	 ぬり
分け られ た 	 わけ られ た
答え られ なかっ た 	 こたえ られ なかっ た
上っ た 	 のぼっ た
ともなう 	 ともなう
燃やし 続ける 	 もやし つづける
陣取る 	 じんどる
静まり返っ た 	 しずまりかえっ た
天下り 	 あまくだり
共通 し て 	 きょうつう し て
加入 し た 	 かにゅう し た
創出 さ れ 	 そうしゅつ さ れ
公布 する 	 こうふ する
学徒動員 し た 	 がくとどういん し た
語り合っ て 	 かたりあっ て
開発 し て 	 かいはつ し て
変更 	 へんこう
染まっ た 	 そまっ た
思 え ぬ 	 おも え ぬ
買収 さ れ た 	 ばいしゅう さ れ た
適用 さ れ なかっ た 	 てきよう さ れ なかっ た
見 出し 	 み だし
表示 し ます 	 ひょうじ し ます
召喚 出来る 	 しょうかん できる
適合 	 てきごう
報道 し 	 ほうどう し
排除 す べき 	 はいじょ す べき
化 し まし た 	 か し まし た
攻撃 し た 	 こうげき し た
流さ れ た 	 ながさ れ た
発表 さ れ 	 はっぴょう さ れ
記入 し て 	 きにゅう し て
応募 出来る 	 おうぼ できる
回転 	 かいてん
引き渡さ れ 	 ひきわたさ れ
抉り 出さ れ て 	 えぐ りださ れ て
はがれ 	 はがれ
焼か ない 	 やか ない
動かす 	 うごかす
まとめ られ た 	 まとめ られ た
巡り会 え た 	 めぐりあ え た
演出 し て 	 えんしゅつ し て
思わ なかっ た 	 おもわ なかっ た
使わ れ なく なり まし た 	 つかわ れ なく なり まし た
集め られ た 	 あつめ られ た
制限 さ れ て 	 せいげん さ れ て
さかのぼる 	 さかのぼる
ともなっ て 	 ともなっ て
着 られ ない 	 き られ ない
叙爵 	 じょしゃく
生み出し て 	 うみだし て
凍りつい 	 こおりつい
果て 	 はて
反応 し ない 	 はんのう し ない
落ち た 	 おち た
沈めろ 	 しずめろ
従わ なく て 	 したがわ なく て
もち 	 もち
伸ばし た 	 のばし た
渡り つづけ た 	 わたり つづけ た
搭載 し て 	 とうさい し て
着 た 	 き た
分身 する 	 ぶんしん する
遮る 	 さえぎる
入り き れ ない 	 はいり き れ ない
すっきりし て 	 すっきりし て
はかどり ます 	 はかどり ます
麻痺 する 	 まひ する
つなげ て 	 つなげ て
取り あっ て 	 とり あっ て
沈ん だ 	 しずん だ
引き受け た 	 ひきうけ た
与え ず 	 あたえ ず
飛び込み 	 とびこみ
代わる 	 かわる
売り出さ れ て 	 うりださ れ て
乗り込み 	 のりこみ
及ぼし て 	 およぼし て
恨ま れる 	 うらま れる
撮ら れ た 	 とら れ た
やる べき 	 やる べき
こだわっ た 	 こだわっ た
味わ え ない 	 あじわ え ない
吸収 し 	 きゅうしゅう し
洗練 さ れ 	 せんれん さ れ
創出 し た 	 そうしゅつ し た
当て て 	 あて て
読み上げ て 	 よみあげ て
示し 始め まし た 	 しめし はじめ まし た
踊る 	 おどる
解明 さ れ 	 かいめい さ れ
制御 する 	 せいぎょ する
確立 さ れ た 	 かくりつ さ れ た
問い詰め られ て 	 といつめ られ て
黙秘 し 	 もくひ し
飲 めれ 	 の めれ
期待 せ ず 	 きたい せ ず
